"geom","min_year","max_year","year_interval","year_count","id"
"POINT(-77.229936 44.152886)",1992,2018,26,"27",13597
"POINT(-65.50048 43.2532)",1983,1994,11,"12",12275
"POINT(-76.06 44.055)",1976,2015,39,"40",13043
"POINT(-74.018383 39.10066)",1982,2015,33,"34",14453
"POINT(-50.370609 48.414273)",1977,2000,23,"24",14393
"POINT(-65.57426 46.98624)",2011,2014,3,"2",15166
"POINT(-65.098835 42.729563)",1979,1992,13,"7",10933
"POINT(-65.3 43)",1970,1997,27,"28",13218
"POINT(-48.319336 48.138699)",1996,2010,14,"15",14875
"POINT(-61.56738 44.19795)",1982,1994,12,"6",12227
"POINT(-63 47)",1976,2014,38,"15",10014
"POINT(-64.965766 47.341712)",2007,2010,3,"3",15785
"POINT(-64.8083 47.67109)",2011,2014,3,"2",15246
"POINT(-55.995809 46.034584)",1970,1994,24,"24",10255
"POINT(-77.396957 43.50608)",1997,2018,21,"22",13989
"POINT(-65.50048 43.2532)",1982,1994,12,"13",11336
"POINT(-79.240319 42.87999)",2003,2008,5,"6",11160
"POINT(-61.56738 44.19795)",1970,1981,11,"12",11731
"POINT(-65.029957 47.777114)",2004,2010,6,"7",15339
"POINT(-66.291594 46.666605)",1970,2014,44,"45",12802
"POINT(-55.995809 46.034584)",1970,1994,24,"24",10776
"POINT(-59.348941 46.441917)",1992,1994,2,"3",10705
"POINT(-61.56738 44.19795)",1995,2016,21,"21",12505
"POINT(-61.56738 44.19795)",1982,1994,12,"13",11714
"POINT(-65.50048 43.2532)",1972,1981,9,"9",12035
"POINT(-61.56738 44.19795)",1970,1981,11,"12",12031
"POINT(-61.164851 45.857738)",1996,1997,1,"2",14055
"POINT(-58.635512 47.364248)",1971,1994,23,"18",10575
"POINT(-61.56738 44.19795)",1995,2016,21,"22",11692
"POINT(-66.11572 44.8247)",1997,2012,15,"16",14773
"POINT(-86 50)",1970,2014,44,"45",12845
"POINT(-55.39306 45.80582)",1983,2013,30,"29",13101
"POINT(-72.88129 46.69751)",2016,2020,4,"2",16053
"POINT(-61.56738 44.19795)",1977,1981,4,"4",12462
"POINT(-67 41)",1950,1998,48,"49",13364
"POINT(-53.37158 51.46769)",1979,2011,32,"33",14665
"POINT(-65.50048 43.2532)",1970,1981,11,"12",11802
"POINT(-61.56738 44.19795)",1982,1994,12,"13",12338
"POINT(-65.50048 43.2532)",1982,1994,12,"13",12466
"POINT(-59.348941 46.441917)",1980,1994,14,"6",11088
"POINT(-48.319336 48.138699)",1996,2010,14,"15",14898
"POINT(-67.506713 41.1087)",1987,2008,21,"22",11245
"POINT(-48.319336 48.138699)",1975,1982,7,"8",14858
"POINT(-78.523333 45.595278)",1952,1995,43,"43",11280
"POINT(-74.381869 45.160229)",1988,2014,26,"3",14042
"POINT(-78.5 45.58333)",1976,1989,13,"14",10123
"POINT(-55.995809 46.034584)",1970,1993,23,"15",10238
"POINT(-57.690888 43.437611)",1973,1992,19,"11",10264
"POINT(-69 43)",1967,1989,22,"23",13377
"POINT(-82.134735 48.575324)",2002,2004,2,"3",10110
"POINT(-61.56738 44.19795)",1995,2016,21,"22",11518
"POINT(-72.88129 46.69751)",2016,2021,5,"6",16015
"POINT(-64.554866 46.218937)",2004,2010,6,"7",15517
"POINT(-61.56738 44.19795)",1982,1994,12,"13",12005
"POINT(-61.56738 44.19795)",1982,1994,12,"13",12002
"POINT(-61.181309 42.866877)",1982,1987,5,"4",10417
"POINT(-61.56738 44.19795)",1970,1981,11,"12",12461
"POINT(-68.3 43.3)",2007,2014,7,"8",14526
"POINT(-74.381869 45.160229)",1998,2016,18,"5",13972
"POINT(-56.383301 46.711721)",1972,1982,10,"10",14945
"POINT(-63.188167 45.760967)",2009,2010,1,"2",15758
"POINT(-72.88129 46.69751)",2016,2020,4,"2",16008
"POINT(-61.181309 42.866877)",1982,1987,5,"5",10997
"POINT(-61.87121 45.68314)",2011,2014,3,"2",15580
"POINT(-66.214847 41.627502)",1980,1993,13,"10",10825
"POINT(-70 60)",1955,1980,25,"26",10094
"POINT(-63.802767 46.136433)",2011,2014,3,"2",15262
"POINT(-63.758716 46.383956)",2007,2008,1,"2",15545
"POINT(-61.455567 46.07815)",2011,2014,3,"2",15366
"POINT(-74.381869 45.160229)",2002,2016,14,"3",13949
"POINT(-79.361398 43.62142)",2006,2012,6,"4",13467
"POINT(-57.690888 43.437611)",1970,1994,24,"25",10304
"POINT(-50.3 44.3)",1965,1986,21,"22",13158
"POINT(-50.75978 47.607599)",1970,1994,24,"25",10144
"POINT(-65.50048 43.2532)",1970,1981,11,"12",11441
"POINT(-65.50048 43.2532)",1982,1994,12,"13",12335
"POINT(-71.71751 46.41901)",2016,2021,5,"3",15987
"POINT(-65.63232 43.2452)",1982,2006,24,"25",14291
"POINT(-63.758716 46.383956)",2011,2014,3,"2",15351
"POINT(-58.635512 47.364248)",1973,1994,21,"8",11019
"POINT(-64.873712 47.473463)",2011,2014,3,"2",15727
"POINT(-61.56738 44.19795)",1982,1994,12,"13",12098
"POINT(-57.854 44.91813)",1970,2002,32,"33",14331
"POINT(-73.107078 52.941847)",1970,2014,44,"45",12870
"POINT(-52 50)",1962,1992,30,"31",13399
"POINT(-72.88129 46.69751)",2016,2020,4,"2",16172
"POINT(-66.089296 44.42804)",1999,2006,7,"8",11142
"POINT(-57.690888 43.437611)",1987,1994,7,"5",10332
"POINT(-64.873712 47.473463)",2005,2008,3,"4",15476
"POINT(-53.864595 53.910492)",1970,1994,24,"24",10929
"POINT(-49.956886 45.114711)",1973,1993,20,"4",10900
"POINT(-61.56738 44.19795)",1970,1981,11,"8",12385
"POINT(-65.228523 46.710388)",1962,2003,41,"38",10118
"POINT(-52.121122 50.695322)",1978,1994,16,"14",11036
"POINT(-56.383301 46.711721)",1984,1993,9,"5",14916
"POINT(-51 49.15)",1980,1996,16,"17",13346
"POINT(-74.58861 36.44722)",1985,2014,29,"30",14744
"POINT(-63.758716 46.383956)",2007,2010,3,"4",15316
"POINT(-61.56738 44.19795)",1970,1981,11,"7",12279
"POINT(-65.25 44.333333)",1996,1997,1,"2",14067
"POINT(-63 47)",1978,1990,12,"13",13226
"POINT(-57.05 51)",1971,1995,24,"25",13400
"POINT(-50.3 44.3)",1965,1986,21,"22",13221
"POINT(-68.615921 41.275324)",1963,2005,42,"43",14273
"POINT(-64.873712 47.473463)",2005,2010,5,"6",15510
"POINT(-84.499722 49.25)",1995,2005,10,"11",9957
"POINT(-56.766309 56.477534)",1978,1991,13,"6",10723
"POINT(-66.75 46.5)",1970,2014,44,"45",12764
"POINT(-72.47958 46.88236)",2016,2021,5,"2",15950
"POINT(-63.728047 47.637685)",1970,1994,24,"25",10172
"POINT(-63.14804 46.23122)",2011,2014,3,"2",15745
"POINT(-68.615921 41.275324)",1963,2005,42,"43",14147
"POINT(-63.446958 46.46855)",2004,2010,6,"7",15391
"POINT(-77.59299 44.01301)",2001,2015,14,"3",13813
"POINT(-82.134735 48.575324)",2002,2004,2,"3",10100
"POINT(-50 43.083333)",2002,2011,9,"10",13440
"POINT(-63.728047 47.637685)",1970,1994,24,"25",10178
"POINT(-77.229936 44.152886)",1992,2018,26,"27",13761
"POINT(-52.121122 50.695322)",1978,1994,16,"5",10924
"POINT(-62.735984 45.290147)",1970,2014,44,"45",12806
"POINT(-69.041914 40.95268)",1967,2014,47,"48",14505
"POINT(-72.82857 45.04889)",2016,2021,5,"3",16080
"POINT(-74.018383 39.10066)",1971,2016,45,"46",14788
"POINT(-65.50048 43.2532)",1970,1980,10,"8",11545
"POINT(-63.758716 46.383956)",2008,2009,1,"2",15715
"POINT(-62.90725 46.058533)",2005,2010,5,"6",15586
"POINT(-69 43)",1967,1989,22,"23",13314
"POINT(-65.50048 43.2532)",1970,1981,11,"12",11790
"POINT(-63.888896 46.512101)",2011,2014,3,"2",15162
"POINT(-59 49.25)",1965,2017,52,"53",14668
"POINT(-68.615921 41.275324)",1970,2016,46,"47",14738
"POINT(-69 43)",1967,1989,22,"23",13187
"POINT(-64.965766 47.341712)",2011,2014,3,"2",15729
"POINT(-50.75978 47.607599)",1970,1994,24,"25",10160
"POINT(-51 49.15)",1980,1996,16,"17",13325
"POINT(-53.75 49.36667)",2000,2003,3,"3",11186
"POINT(-50 43.083333)",2002,2011,9,"10",13437
"POINT(-51.10417 45.91944)",1977,2000,23,"24",11192
"POINT(-64.56477 46.273319)",2011,2014,3,"2",15169
"POINT(-61.56738 44.19795)",1982,1994,12,"13",11977
"POINT(-74.381869 45.160229)",1984,2008,24,"5",13996
"POINT(-74.018383 39.10066)",1968,2011,43,"44",14426
"POINT(-61.56738 44.19795)",1982,1994,12,"13",12615
"POINT(-61.56738 44.19795)",1995,2016,21,"21",11971
"POINT(-71.71751 46.41901)",2018,2020,2,"3",16193
"POINT(-65.50048 43.2532)",1970,1981,11,"12",11523
"POINT(-57.690888 43.437611)",1979,1993,14,"13",10854
"POINT(-63.66575 45.8547)",2004,2010,6,"5",15520
"POINT(-65.50048 43.2532)",1970,1981,11,"12",12555
"POINT(-73.43806 38.53306)",1963,2009,46,"47",14530
"POINT(-77.072526 44.096244)",1992,2018,26,"27",13611
"POINT(-73.43806 38.53306)",1963,2009,46,"47",14670
"POINT(-71.093778 40.671798)",1967,2005,38,"39",14175
"POINT(-49.931212 51.171824)",1983,2011,28,"29",14334
"POINT(-64.657552 47.746584)",2011,2014,3,"2",15500
"POINT(-59.12841 47.47266)",1974,2010,36,"37",14524
"POINT(-61.56738 44.19795)",1970,1981,11,"12",11944
"POINT(-61.1985 45.9668)",1996,1997,1,"2",14056
"POINT(-50.457342 50.936521)",1995,2009,14,"15",14844
"POINT(-65.57426 46.98624)",2011,2014,3,"2",15470
"POINT(-65.029957 47.777114)",2004,2010,6,"7",15417
"POINT(-61.56738 44.19795)",1983,1993,10,"6",12129
"POINT(-49.956886 45.114711)",1970,1985,15,"3",10411
"POINT(-84.52551 50.219196)",2016,2017,1,"2",14990
"POINT(-63.888896 46.512101)",2009,2010,1,"2",15527
"POINT(-68.615921 41.275324)",1950,2007,57,"58",14571
"POINT(-72.47958 46.88236)",2016,2021,5,"2",15924
"POINT(-55.49865 49.00565)",2015,2016,1,"2",11313
"POINT(-64.573724 46.34102)",2004,2010,6,"7",15170
"POINT(-61.56738 44.19795)",1970,1981,11,"12",12273
"POINT(-63 45)",1970,2012,42,"43",12753
"POINT(-79.85068 43.28331)",2006,2015,9,"6",13865
"POINT(-60.3 44.1)",1967,1990,23,"24",13165
"POINT(-64.56477 46.273319)",2007,2010,3,"2",15584
"POINT(-84.499722 49.25)",1995,2006,11,"12",9979
"POINT(-61.56738 44.19795)",1972,1981,9,"6",12339
"POINT(-71.71751 46.41901)",2017,2021,4,"5",15920
"POINT(-50.457342 50.936521)",1993,1994,1,"2",14837
"POINT(-81.87611 45.625)",1950,1983,33,"34",13254
"POINT(-63.739472 45.85055)",2005,2009,4,"5",15078
"POINT(-53.864595 53.910492)",1977,1990,13,"5",10712
"POINT(-65.50048 43.2532)",1995,2016,21,"22",11687
"POINT(-60.3 44.1)",1967,1990,23,"24",13332
"POINT(-70.87637 46.85767)",2016,2020,4,"3",15946
"POINT(-71.093778 40.671798)",1968,2006,38,"39",14127
"POINT(-71.45194 41.43083)",1990,1998,8,"9",13064
"POINT(-53.37158 51.46769)",1979,2011,32,"33",14749
"POINT(-65.50048 43.2532)",1974,1978,4,"2",12639
"POINT(-77.59299 44.01301)",2001,2015,14,"3",13810
"POINT(-65.50048 43.2532)",1995,2016,21,"22",12533
"POINT(-64.573724 46.34102)",2011,2014,3,"2",15679
"POINT(-79.85068 43.28331)",2006,2015,9,"6",13822
"POINT(-61.181309 42.866877)",1977,1993,16,"13",10220
"POINT(-61.181309 42.866877)",1983,1987,4,"3",10895
"POINT(-49.931212 51.171824)",1983,2011,28,"29",14159
"POINT(-76.794435 44.062208)",1992,2018,26,"27",13736
"POINT(-62.511072 46.018891)",2011,2014,3,"2",15293
"POINT(-65.50048 43.2532)",1982,1992,10,"6",11844
"POINT(-61.181309 42.866877)",1979,1990,11,"3",10232
"POINT(-66.11572 44.8247)",1997,2012,15,"16",14633
"POINT(-67 43)",1970,2010,40,"41",14264
"POINT(-57.05 51)",1971,1995,24,"25",13232
"POINT(-73.148804 47.931066)",1965,2013,48,"49",11129
"POINT(-77.229936 44.152886)",1992,2018,26,"27",13607
"POINT(-65.50048 43.2532)",1996,2016,20,"18",12608
"POINT(-74.381869 45.160229)",1984,2018,34,"17",13750
"POINT(-68.615921 41.275324)",1963,2005,42,"43",14122
"POINT(-61.56738 44.19795)",1977,1981,4,"2",11597
"POINT(-61.56738 44.19795)",1982,1994,12,"13",12290
"POINT(-61.56738 44.19795)",1982,1994,12,"13",11568
"POINT(-59.348941 46.441917)",1970,1994,24,"13",10830
"POINT(-65.50048 43.2532)",1982,1994,12,"12",11767
"POINT(-61.56738 44.19795)",1995,2016,21,"22",11425
"POINT(-61.56738 44.19795)",1984,1994,10,"10",11902
"POINT(-84.499722 49.25)",1995,2004,9,"9",9980
"POINT(-56.383301 46.711721)",1984,1995,11,"12",14869
"POINT(-79.85068 43.28331)",2006,2015,9,"6",13828
"POINT(-77.229936 44.152886)",1992,2018,26,"27",13722
"POINT(-59.853639 59.286076)",1978,1988,10,"5",10330
"POINT(-62.067902 49.652037)",1984,1992,8,"4",10946
"POINT(-64.126831 46.773778)",2011,2014,3,"2",15376
"POINT(-63.14804 46.23122)",2011,2014,3,"2",15299
"POINT(-57.690888 43.437611)",1981,1987,6,"4",10392
"POINT(-61.56738 44.19795)",1970,1981,11,"4",12147
"POINT(-74.018383 39.10066)",1975,2005,30,"31",14195
"POINT(-55.731995 54.718454)",1978,1984,6,"7",13029
"POINT(-63.126667 46.235)",1998,1999,1,"2",14981
"POINT(-79.361398 43.62142)",2006,2012,6,"4",13578
"POINT(-61.017433 46.6243)",2011,2014,3,"2",15579
"POINT(-56.383301 46.711721)",1996,2010,14,"14",14890
"POINT(-63.66575 45.8547)",2004,2010,6,"7",15211
"POINT(-82.517801 41.970728)",2002,2003,1,"2",15028
"POINT(-68.615921 41.275324)",1970,2016,46,"47",14766
"POINT(-58.452138 49.69674)",1970,1994,24,"24",10775
"POINT(-77.229936 44.152886)",1992,2018,26,"27",13717
"POINT(-63.421546 46.34346)",2009,2011,2,"3",12934
"POINT(-63.14804 46.23122)",2006,2010,4,"3",15334
"POINT(-79.85068 43.28331)",2014,2015,1,"2",13881
"POINT(-77.72313 43.99472)",2008,2015,7,"2",13841
"POINT(-74.018383 39.10066)",1975,2005,30,"31",14395
"POINT(-65.50048 43.2532)",1982,1993,11,"4",12104
"POINT(-64.126831 46.773778)",2011,2014,3,"2",15674
"POINT(-77.547686 43.947746)",1992,2012,20,"21",13536
"POINT(-63 47)",1971,2016,45,"46",10064
"POINT(-78.523333 45.595278)",1952,1995,43,"43",12962
"POINT(-66.214847 41.627502)",1980,1993,13,"11",10864
"POINT(-61.56738 44.19795)",1995,2016,21,"22",11769
"POINT(-62.44628 43.89789)",1974,2008,34,"35",14363
"POINT(-61.56738 44.19795)",1982,1993,11,"12",11626
"POINT(-65.3 43)",1962,1988,26,"27",13177
"POINT(-61.56738 44.19795)",1974,1981,7,"6",12249
"POINT(-61.56738 44.19795)",1970,1981,11,"12",12060
"POINT(-62.28626 46.36766)",2008,2010,2,"3",15074
"POINT(-79.361398 43.62142)",2006,2012,6,"4",13572
"POINT(-71.71751 46.41901)",2017,2021,4,"3",16215
"POINT(-71.093778 40.671798)",1967,2005,38,"39",14200
"POINT(-64.11454 46.1827)",2009,2010,1,"2",15650
"POINT(-63 47)",1971,2016,45,"37",10012
"POINT(-67 43)",1970,2010,40,"41",14189
"POINT(-71.093778 40.671798)",1989,2016,27,"28",14657
"POINT(-64.126831 46.773778)",2004,2010,6,"7",15526
"POINT(-61.455567 46.07815)",2011,2014,3,"2",15297
"POINT(-65.50048 43.2532)",1995,2016,21,"22",11908
"POINT(-76.016667 43.133333)",2006,2014,8,"9",13022
"POINT(-61.56738 44.19795)",1970,1981,11,"12",11891
"POINT(-72 40)",1973,2016,43,"44",14669
"POINT(-78.523333 45.595278)",1972,1991,19,"19",12944
"POINT(-65.50048 43.2532)",1995,2016,21,"22",12637
"POINT(-49.956886 45.114711)",1972,1994,22,"16",11064
"POINT(-61.56738 44.19795)",1995,2016,21,"22",12101
"POINT(-61.56738 44.19795)",1970,1981,11,"12",12217
"POINT(-63 47)",1978,1990,12,"13",13205
"POINT(-74.58861 36.44722)",1981,2008,27,"28",14253
"POINT(-62.916667 47.416667)",1971,2012,41,"42",15042
"POINT(-55.3 46)",1959,1993,34,"35",13159
"POINT(-61.56738 44.19795)",1995,2010,15,"11",11358
"POINT(-51 49.15)",1980,1996,16,"17",13262
"POINT(-51.3 44.3)",1968,1986,18,"19",13340
"POINT(-55.3 46)",1959,1993,34,"35",13348
"POINT(-69 43)",1967,1989,22,"23",13356
"POINT(-78.291582 43.944964)",1987,2016,29,"30",14045
"POINT(-61.56738 44.19795)",1982,1994,12,"12",12314
"POINT(-65.3 43)",1970,1997,27,"28",13134
"POINT(-63.2 42)",1973,1986,13,"14",13161
"POINT(-65.50048 43.2532)",1995,2016,21,"22",11945
"POINT(-61.56738 44.19795)",1995,2016,21,"22",11446
"POINT(-61.1985 45.9668)",1996,1997,1,"2",14093
"POINT(-52 50)",1962,1992,30,"31",13252
"POINT(-62.28626 46.36766)",2009,2010,1,"2",15559
"POINT(-61.56738 44.19795)",1996,2008,12,"9",11332
"POINT(-72.88129 46.69751)",2016,2021,5,"6",16162
"POINT(-63.66575 45.8547)",2011,2014,3,"2",15735
"POINT(-67.064717 44.266029)",1971,1994,23,"18",10223
"POINT(-61.56738 44.19795)",1982,1984,2,"2",12610
"POINT(-65.50048 43.2532)",1995,2016,21,"22",12316
"POINT(-69.041914 40.95268)",1984,2016,32,"33",14419
"POINT(-65.50048 43.2532)",1995,2016,21,"22",12465
"POINT(-61.017433 46.6243)",2008,2010,2,"3",15696
"POINT(-81.87611 45.625)",1950,1983,33,"34",13380
"POINT(-81.10944 44.42389)",1992,1994,2,"3",13008
"POINT(-61.56738 44.19795)",1982,1994,12,"13",11710
"POINT(-65.57426 46.98624)",2008,2010,2,"3",15222
"POINT(-53.172992 49.757443)",1981,1994,13,"14",11290
"POINT(-48.319336 48.138699)",1975,1982,7,"8",14930
"POINT(-72.82857 45.04889)",2016,2019,3,"2",16184
"POINT(-77.229936 44.152886)",1992,2018,26,"27",13599
"POINT(-65.63232 43.2452)",1982,2006,24,"25",14366
"POINT(-50.370609 48.414273)",1977,2000,23,"24",14318
"POINT(-70.87637 46.85767)",2018,2020,2,"2",16085
"POINT(-65.50048 43.2532)",1982,1994,12,"13",11319
"POINT(-68.615921 41.275324)",1963,2005,42,"43",14149
"POINT(-50.521046 49.772834)",1975,2006,31,"32",14786
"POINT(-50.370609 48.414273)",1977,2000,23,"24",14268
"POINT(-65.098835 42.729563)",1970,1994,24,"25",10202
"POINT(-55.995809 46.034584)",1974,1994,20,"16",10361
"POINT(-61.56738 44.19795)",1982,1994,12,"13",11350
"POINT(-53.864595 53.910492)",1970,1994,24,"24",10156
"POINT(-61.56738 44.19795)",1970,1981,11,"12",12620
"POINT(-61.71722 48.33722)",1978,2000,22,"23",11194
"POINT(-52.121122 50.695322)",1978,1994,16,"10",10370
"POINT(-66.11667 46.55)",1970,2014,44,"45",12767
"POINT(-65.50048 43.2532)",2001,2015,14,"4",12281
"POINT(-56.383301 46.711721)",1984,1991,7,"5",14918
"POINT(-64.965766 47.341712)",2004,2010,6,"7",15271
"POINT(-51.19117 50.037337)",1978,1994,16,"17",11199
"POINT(-77.72313 43.99472)",2008,2015,7,"2",13807
"POINT(-65.50048 43.2532)",1995,2014,19,"17",11816
"POINT(-58.452138 49.69674)",1970,1994,24,"24",10956
"POINT(-64.873712 47.473463)",2011,2014,3,"2",15280
"POINT(-72.88129 46.69751)",2016,2021,5,"4",15963
"POINT(-84.499722 49.25)",1995,2006,11,"12",9990
"POINT(-61.56738 44.19795)",1991,1993,2,"3",11353
"POINT(-65.562778 46.995278)",2011,2014,3,"2",15363
"POINT(-72.82857 45.04889)",2016,2021,5,"3",16178
"POINT(-65.50048 43.2532)",1995,2016,21,"22",12322
"POINT(-62.067902 49.652037)",1988,1994,6,"3",10334
"POINT(-63.888896 46.512101)",2011,2014,3,"2",15742
"POINT(-67 41)",1950,1998,48,"49",13175
"POINT(-61.56738 44.19795)",1970,1981,11,"12",12152
"POINT(-77.547686 43.947746)",1992,2018,26,"27",13690
"POINT(-84.499722 49.25)",1995,2004,9,"9",9992
"POINT(-51.19117 50.037337)",1995,2001,6,"7",11198
"POINT(-49.931212 51.171824)",1983,2011,28,"29",14184
"POINT(-64.951922 46.75123)",2004,2010,6,"4",15558
"POINT(-68.615921 41.275324)",1963,2016,53,"54",14652
"POINT(-63.188167 45.760967)",2009,2010,1,"2",15627
"POINT(-61.181309 42.866877)",1970,1994,24,"25",10150
"POINT(-61.56738 44.19795)",1970,1981,11,"9",12185
"POINT(-68.615921 41.275324)",1950,2007,57,"58",14795
"POINT(-58.452138 49.69674)",1972,1994,22,"20",10760
"POINT(-56.654374 47.5504)",1994,2010,16,"17",11285
"POINT(-61.56738 44.19795)",1982,1994,12,"13",11763
"POINT(-76.794435 44.062208)",1992,2018,26,"27",13622
"POINT(-48.319336 48.138699)",1996,2010,14,"15",14900
"POINT(-74 41.16667)",1980,2000,20,"21",13019
"POINT(-64.573724 46.34102)",2011,2014,3,"2",15383
"POINT(-59 49.25)",1965,2017,52,"53",14556
"POINT(-72 54)",1970,2014,44,"45",12796
"POINT(-62.11238 46.383134)",2011,2014,3,"2",15157
"POINT(-77.547686 43.947746)",1992,2012,20,"21",13510
"POINT(-68.3 43.3)",2007,2014,7,"8",14610
"POINT(-79.361398 43.62142)",2006,2012,6,"4",13463
"POINT(-61.56738 44.19795)",1995,2016,21,"22",12201
"POINT(-59 49.25)",1965,2017,52,"53",14780
"POINT(-73.795833 45.016389)",2003,2004,1,"2",13075
"POINT(-65.50048 43.2532)",1995,2016,21,"22",11973
"POINT(-86 50)",1970,2014,44,"45",12858
"POINT(-63.728047 47.637685)",1973,1994,21,"16",10473
"POINT(-65.50048 43.2532)",1995,2016,21,"22",12179
"POINT(-81.963458 42.705841)",2002,2003,1,"2",13111
"POINT(-77.22225 44.149251)",2001,2015,14,"14",13875
"POINT(-78.5 45.58333)",1976,1989,13,"14",10122
"POINT(-73.795833 45.016389)",2003,2004,1,"2",13077
"POINT(-65.50048 43.2532)",1995,2016,21,"8",12360
"POINT(-53.864595 53.910492)",1971,1994,23,"8",10737
"POINT(-61.455567 46.07815)",2004,2010,6,"7",15592
"POINT(-65.63232 43.2452)",1970,2010,40,"41",14361
"POINT(-74.58861 36.44722)",1981,2008,27,"28",14378
"POINT(-65.50048 43.2532)",1995,2016,21,"17",11904
"POINT(-78.523333 45.595278)",1972,1991,19,"19",12950
"POINT(-61.56738 44.19795)",1970,1981,11,"4",12414
"POINT(-65.50048 43.2532)",1995,2014,19,"17",12617
"POINT(-78.733333 50.2)",2001,2009,8,"9",12926
"POINT(-66.35 44.75)",1983,2008,25,"26",11241
"POINT(-74.018383 39.10066)",1982,2015,33,"34",14537
"POINT(-68.615921 41.275324)",1963,2005,42,"43",14349
"POINT(-61.56738 44.19795)",1971,1981,10,"6",11656
"POINT(-80.98194 43.37)",1992,1994,2,"3",13010
"POINT(-72.82857 45.04889)",2016,2021,5,"3",16077
"POINT(-62.067902 49.652037)",1972,1994,22,"22",10536
"POINT(-72 54)",1970,2014,44,"45",12679
"POINT(-65.50048 43.2532)",1970,1981,11,"12",12288
"POINT(-61.455567 46.07815)",2011,2014,3,"2",15434
"POINT(-65.50048 43.2532)",1970,1981,11,"12",12529
"POINT(-77.396957 43.50608)",1997,2018,21,"22",14032
"POINT(-65.50048 43.2532)",1995,2016,21,"22",12293
"POINT(-82.45056 42.31778)",1985,1994,9,"10",14822
"POINT(-58.635512 47.364248)",1971,1994,23,"21",10609
"POINT(-72.88129 46.69751)",2017,2021,4,"4",15986
"POINT(-59.348941 46.441917)",1977,1994,17,"15",10321
"POINT(-62.511072 46.018891)",2005,2010,5,"6",15407
"POINT(-78.523333 45.595278)",1952,1995,43,"43",11277
"POINT(-69.041914 40.95268)",1969,2008,39,"40",14784
"POINT(-68.615921 41.275324)",1950,2016,66,"67",14740
"POINT(-66.46191 46.56531)",2008,2013,5,"2",12936
"POINT(-49.956886 45.114711)",1970,1994,24,"25",10212
"POINT(-72.82857 45.04889)",2016,2019,3,"2",16224
"POINT(-65.50048 43.2532)",1970,1981,11,"12",12127
"POINT(-61.56738 44.19795)",1995,2016,21,"22",11338
"POINT(-65.50048 43.2532)",1984,1994,10,"10",12612
"POINT(-61.017433 46.6243)",2008,2010,2,"3",15428
"POINT(-68.871657 43.27657)",1982,2014,32,"33",14511
"POINT(-62.74132 45.67583)",2009,2010,1,"2",15482
"POINT(-79.361398 43.62142)",2006,2012,6,"4",13523
"POINT(-56.383301 46.711721)",1999,2010,11,"10",14913
"POINT(-76.794435 44.062208)",1992,2018,26,"27",13680
"POINT(-62.067902 49.652037)",1977,1991,14,"6",10739
"POINT(-64.573724 46.34102)",2004,2010,6,"5",15799
"POINT(-61.181309 42.866877)",1970,1994,24,"25",10866
"POINT(-74.381869 45.160229)",1984,2018,34,"17",13758
"POINT(-61.56738 44.19795)",1982,1994,12,"13",12476
"POINT(-61.56738 44.19795)",1970,1981,11,"12",11435
"POINT(-72.88129 46.69751)",2016,2021,5,"6",16043
"POINT(-53.864595 53.910492)",1971,1994,23,"21",10364
"POINT(-50.521046 49.772834)",1975,2006,31,"32",14730
"POINT(-65.63232 43.2452)",1982,2006,24,"25",14391
"POINT(-52.782383 44.683779)",1981,1993,12,"5",11003
"POINT(-81.87611 45.625)",1950,1983,33,"34",13275
"POINT(-62.067902 49.652037)",1978,1993,15,"11",10556
"POINT(-78.523333 45.595278)",1952,1995,43,"43",12953
"POINT(-78.291582 43.944964)",1987,2016,29,"30",13919
"POINT(-68.615921 41.275324)",1970,2016,46,"47",14654
"POINT(-74.58861 36.44722)",1985,2014,29,"30",14576
"POINT(-61.56738 44.19795)",1982,1994,12,"13",12632
"POINT(-52.757812 52.054271)",1995,2009,14,"15",14932
"POINT(-60.3 44.1)",1967,1990,23,"24",13333
"POINT(-62.4353 54.17529)",1980,2016,36,"10",12741
"POINT(-65.50048 43.2532)",1982,1994,12,"13",12199
"POINT(-55.995809 46.034584)",1977,1994,17,"3",10548
"POINT(-56.766309 56.477534)",1978,1988,10,"5",10230
"POINT(-52.757812 52.054271)",1977,1994,17,"18",14888
"POINT(-62.650653 47.394909)",1952,2012,60,"60",11299
"POINT(-75.363333 35.224444)",1992,1993,1,"2",12654
"POINT(-64.951922 46.75123)",2005,2010,5,"6",15448
"POINT(-71.71751 46.41901)",2018,2021,3,"3",15954
"POINT(-65.50048 43.2532)",1995,2016,21,"22",11664
"POINT(-61.56738 44.19795)",1971,1974,3,"2",12032
"POINT(-65.50048 43.2532)",1982,1988,6,"5",12317
"POINT(-65.098835 42.729563)",1985,1994,9,"4",10919
"POINT(-72.88129 46.69751)",2016,2020,4,"4",16113
"POINT(-77.22225 44.149251)",2001,2015,14,"14",13852
"POINT(-56.383301 46.711721)",1999,2010,11,"10",14961
"POINT(-55.995809 46.034584)",1975,1986,11,"5",10947
"POINT(-86 50)",1970,2014,44,"45",12789
"POINT(-64.573724 46.34102)",2004,2010,6,"7",15597
"POINT(-65.50048 43.2532)",1995,2016,21,"22",12403
"POINT(-58.452138 49.69674)",1972,1994,22,"17",10652
"POINT(-53.864595 53.910492)",1971,1984,13,"6",10551
"POINT(-62.74132 45.67583)",2007,2008,1,"2",15719
"POINT(-62.90725 46.058533)",2005,2010,5,"6",15112
"POINT(-77.229936 44.152886)",1992,2018,26,"27",13770
"POINT(-79.85068 43.28331)",2014,2015,1,"2",13848
"POINT(-61.56738 44.19795)",1995,2016,21,"21",12337
"POINT(-61.56738 44.19795)",1995,2016,21,"21",12018
"POINT(-65.50048 43.2532)",1970,1981,11,"12",11871
"POINT(-79.361398 43.62142)",2006,2012,6,"4",13461
"POINT(-76.06 44.055)",1976,2015,39,"40",13048
"POINT(-66.214847 41.627502)",1981,1993,12,"10",11067
"POINT(-69.041914 40.95268)",1984,2016,32,"33",14727
"POINT(-61.56738 44.19795)",1982,1994,12,"13",11873
"POINT(-70.87637 46.85767)",2016,2017,1,"2",16110
"POINT(-86 50)",1970,2014,44,"45",12861
"POINT(-71.093778 40.671798)",1968,2006,38,"39",14252
"POINT(-63.14804 46.23122)",2011,2014,3,"2",15677
"POINT(-61.56738 44.19795)",1970,1981,11,"12",12558
"POINT(-61.56738 44.19795)",1982,1994,12,"13",11968
"POINT(-63.728047 47.637685)",1974,1994,20,"12",10479
"POINT(-69.041914 40.95268)",1967,2014,47,"48",14477
"POINT(-80.158424 42.549539)",1971,1999,28,"15",14108
"POINT(-62.90725 46.058533)",2011,2014,3,"2",15247
"POINT(-65.50048 43.2532)",1982,1994,12,"13",11962
"POINT(-77.22225 44.149251)",2001,2015,14,"14",13829
"POINT(-68.41917 37.14722)",1987,2000,13,"14",10004
"POINT(-65.50048 43.2532)",1985,1993,8,"2",11653
"POINT(-78.523333 45.595278)",1980,2013,33,"34",13030
"POINT(-73.107078 52.941847)",1970,2014,44,"45",12867
"POINT(-57.690888 43.437611)",1980,1993,13,"8",11000
"POINT(-65.50048 43.2532)",1982,1994,12,"13",12096
"POINT(-64.873712 47.473463)",2005,2008,3,"3",15582
"POINT(-66.214847 41.627502)",1987,1993,6,"7",10222
"POINT(-47.315252 41.630515)",1996,2009,13,"11",14841
"POINT(-65.63232 43.2452)",1970,2007,37,"38",14254
"POINT(-78.523333 45.595278)",1952,1995,43,"43",12952
"POINT(-49.931212 51.171824)",1983,2011,28,"29",14209
"POINT(-63 47)",1974,2016,42,"33",10047
"POINT(-65.50048 43.2532)",1982,1994,12,"13",11876
"POINT(-56 52)",1974,2014,40,"41",12766
"POINT(-64.965766 47.341712)",2006,2010,4,"5",15477
"POINT(-50.75978 47.607599)",1970,1994,24,"25",10173
"POINT(-79.85068 43.28331)",2006,2015,9,"6",13859
"POINT(-77.22225 44.149251)",2001,2013,12,"12",13589
"POINT(-74.018383 39.10066)",1975,2005,30,"31",14370
"POINT(-72 40)",1973,2016,43,"44",14753
"POINT(-64.965766 47.341712)",2011,2014,3,"2",15807
"POINT(-77.59299 44.01301)",2001,2015,14,"3",13845
"POINT(-63 45)",1970,2014,44,"45",12772
"POINT(-61.56738 44.19795)",1995,2016,21,"22",12029
"POINT(-79.361398 43.62142)",2006,2012,6,"4",13489
"POINT(-86 50)",1970,2014,44,"45",12671
"POINT(-77.396957 43.50608)",1978,2018,40,"40",13903
"POINT(-65.50048 43.2532)",1995,2016,21,"22",12334
"POINT(-65.098835 42.729563)",1974,1987,13,"4",11029
"POINT(-61.56738 44.19795)",1995,2016,21,"21",11536
"POINT(-65.25 44.333333)",1996,1997,1,"2",14083
"POINT(-60.3 44.1)",1967,1990,23,"24",13186
"POINT(-65.63232 43.2452)",1970,2007,37,"38",14154
"POINT(-56.766309 56.477534)",1977,1988,11,"9",10275
"POINT(-75.53 35.224444)",1992,1993,1,"2",12727
"POINT(-61.56738 44.19795)",1995,2016,21,"22",12631
"POINT(-60.3 44.1)",1967,1990,23,"24",13248
"POINT(-74.381869 45.160229)",1998,2010,12,"2",13976
"POINT(-65.029957 47.777114)",2007,2009,2,"3",15459
"POINT(-71.093778 40.671798)",1967,2005,38,"39",14225
"POINT(-72.47958 46.88236)",2016,2021,5,"2",16029
"POINT(-65.63232 43.2452)",1980,2008,28,"29",14330
"POINT(-77.59299 44.01301)",2001,2015,14,"3",13879
"POINT(-65.50048 43.2532)",1996,2016,20,"12",12644
"POINT(-68.3 43.3)",2007,2014,7,"8",14722
"POINT(-61.56738 44.19795)",1984,1994,10,"10",11368
"POINT(-65.50048 43.2532)",1995,2016,21,"22",11473
"POINT(-71.71751 46.41901)",2017,2021,4,"4",16052
"POINT(-71.71751 46.41901)",2016,2021,5,"6",16040
"POINT(-62.86667 48.82361)",1987,2011,24,"25",11206
"POINT(-74.018383 39.10066)",1973,2002,29,"30",14346
"POINT(-63.728047 47.637685)",1970,1994,24,"25",11073
"POINT(-72.47958 46.88236)",2016,2021,5,"2",16120
"POINT(-63 47)",1978,1990,12,"13",13393
"POINT(-48.319336 48.138699)",1984,1995,11,"12",14902
"POINT(-66.11572 44.8247)",1997,2012,15,"16",14661
"POINT(-72.47958 46.88236)",2016,2021,5,"2",16024
"POINT(-65.098835 42.729563)",1974,1983,9,"4",10725
"POINT(-59 49.25)",1965,2017,52,"53",14584
"POINT(-55.995809 46.034584)",1972,1987,15,"10",11062
"POINT(-74.381869 45.160229)",1984,2016,32,"16",13698
"POINT(-80.417572 42.579883)",1989,2012,23,"24",12982
"POINT(-67.064717 44.266029)",1971,1992,21,"14",10338
"POINT(-64.209251 44.537006)",1985,2012,27,"19",11296
"POINT(-65.50048 43.2532)",1970,1981,11,"12",11406
"POINT(-57.41455 46.93526)",1983,2011,28,"28",14333
"POINT(-65.3 43)",1962,1988,26,"27",13219
"POINT(-61.56738 44.19795)",1972,1981,9,"2",11911
"POINT(-65.562778 46.995278)",2011,2014,3,"2",15673
"POINT(-77.59299 44.01301)",2001,2015,14,"3",13826
"POINT(-77.547686 43.947746)",1992,2018,26,"27",13744
"POINT(-61.56738 44.19795)",1995,2016,21,"22",12351
"POINT(-77.229936 44.152886)",1992,2018,26,"27",13703
"POINT(-65.50048 43.2532)",1995,2016,21,"22",12560
"POINT(-62.90725 46.058533)",2011,2014,3,"2",15291
"POINT(-63.188167 45.760967)",2009,2010,1,"2",15555
"POINT(-65.50048 43.2532)",1996,2016,20,"15",11716
"POINT(-77.396957 43.50608)",1978,2018,40,"40",14029
"POINT(-77.72313 43.99472)",2008,2015,7,"2",13880
"POINT(-50.521046 49.772834)",1975,2006,31,"32",14646
"POINT(-61.56738 44.19795)",1995,2016,21,"10",12342
"POINT(-65.50048 43.2532)",1982,1994,12,"8",12458
"POINT(-74.381869 45.160229)",2012,2018,6,"4",14040
"POINT(-65.50048 43.2532)",1970,1980,10,"8",12346
"POINT(-63 47)",1974,2016,42,"37",10026
"POINT(-62.28626 46.36766)",2008,2010,2,"3",15205
"POINT(-51.3 44.3)",1968,1986,18,"19",13256
"POINT(-79.361398 43.62142)",2006,2012,6,"4",13478
"POINT(-86 50)",1970,2014,44,"45",12785
"POINT(-76.06 44.055)",1979,2015,36,"15",13044
"POINT(-57.690888 43.437611)",1974,1991,17,"9",11122
"POINT(-65.50048 43.2532)",1970,1981,11,"12",11320
"POINT(-68.615921 41.275324)",1963,2009,46,"47",14737
"POINT(-79.361398 43.62142)",2006,2012,6,"4",13522
"POINT(-77.229936 44.152886)",1992,2018,26,"27",14004
"POINT(-72.957967 46.778085)",1971,2000,29,"9",13108
"POINT(-77.22225 44.149251)",2001,2015,14,"14",13825
"POINT(-49.956886 45.114711)",1973,1985,12,"4",10779
"POINT(-72.82857 45.04889)",2016,2021,5,"3",15923
"POINT(-77.22225 44.149251)",2001,2015,14,"14",13809
"POINT(-74.018383 39.10066)",1967,2005,38,"39",14269
"POINT(-61.56738 44.19795)",1970,1981,11,"12",12425
"POINT(-62.90725 46.058533)",2005,2010,5,"6",15405
"POINT(-61.56738 44.19795)",1995,2016,21,"22",11737
"POINT(-77.72313 43.99472)",2008,2015,7,"2",13821
"POINT(-65.50048 43.2532)",1970,1981,11,"11",11898
"POINT(-80.41667 42.57944)",1988,2008,20,"21",12985
"POINT(-60.3 44.1)",1967,1990,23,"24",13416
"POINT(-70.87637 46.85767)",2016,2020,4,"5",15894
"POINT(-52.121122 50.695322)",1970,1994,24,"23",10273
"POINT(-65.50048 43.2532)",1982,1994,12,"13",12232
"POINT(-79.633333 43.683333)",1978,1981,3,"4",10069
"POINT(-65.50048 43.2532)",1970,1978,8,"6",11380
"POINT(-65.50048 43.2532)",1970,1981,11,"12",12233
"POINT(-74.018383 39.10066)",1975,2005,30,"31",14220
"POINT(-65.50048 43.2532)",1995,2016,21,"21",11650
"POINT(-65.50048 43.2532)",1996,2016,20,"18",12341
"POINT(-77.59299 44.01301)",2001,2015,14,"3",13892
"POINT(-61.56738 44.19795)",1970,1981,11,"12",11998
"POINT(-63.902612 46.237205)",2001,2006,5,"6",10082
"POINT(-47.89333 50.44083)",1983,2018,35,"36",14365
"POINT(-72.82857 45.04889)",2016,2019,3,"2",16021
"POINT(-61.56738 44.19795)",1995,2016,21,"15",12380
"POINT(-61.56738 44.19795)",1982,1994,12,"13",12244
"POINT(-63 47)",1971,2016,45,"46",10019
"POINT(-79.361398 43.62142)",2006,2012,6,"4",13464
"POINT(-79.361398 43.62142)",2006,2012,6,"4",13526
"POINT(-76.698994 45.649011)",1997,2000,3,"2",12997
"POINT(-65.098835 42.729563)",1979,1994,15,"12",10414
"POINT(-65.50048 43.2532)",1984,1994,10,"10",11811
"POINT(-66.214847 41.627502)",1986,1993,7,"3",10940
"POINT(-66.486934 47.136578)",2001,2002,1,"2",15856
"POINT(-65.562778 46.995278)",2004,2010,6,"7",15085
"POINT(-80.41667 42.57944)",1988,1994,6,"7",12984
"POINT(-72.82857 45.04889)",2016,2021,5,"3",16047
"POINT(-56.383301 46.711721)",1996,2008,12,"5",14891
"POINT(-51.3 44.3)",1968,1986,18,"19",13319
"POINT(-61.56738 44.19795)",1970,1981,11,"12",11725
"POINT(-63.07912 47.227308)",1985,2012,27,"27",11283
"POINT(-65.50048 43.2532)",1970,1981,11,"12",11860
"POINT(-62.067902 49.652037)",1985,1994,9,"10",11016
"POINT(-68.526458 40.575228)",1964,2016,52,"53",14742
"POINT(-61.56738 44.19795)",1982,1994,12,"13",12151
"POINT(-61.56738 44.19795)",1983,1993,10,"6",12396
"POINT(-65.50048 43.2532)",1982,1994,12,"13",11609
"POINT(-71.71751 46.41901)",2016,2021,5,"6",16153
"POINT(-65.50048 43.2532)",1995,2016,21,"22",11369
"POINT(-55.225157 50.548819)",1968,2011,43,"9",12971
"POINT(-63.14804 46.23122)",2006,2010,4,"3",15594
"POINT(-61.181309 42.866877)",1970,1994,24,"25",10303
"POINT(-61.56738 44.19795)",1983,1994,11,"11",12384
"POINT(-77.72313 43.99472)",2008,2015,7,"2",13831
"POINT(-57.690888 43.437611)",1970,1994,24,"25",10138
"POINT(-63 47)",1978,1990,12,"13",13330
"POINT(-65.50048 43.2532)",1982,1993,11,"4",11837
"POINT(-78.523333 45.595278)",1952,1995,43,"43",12960
"POINT(-77 57.83333)",1964,1979,15,"16",10116
"POINT(-61.56738 44.19795)",1985,1994,9,"4",11508
"POINT(-61.56738 44.19795)",1995,2016,21,"22",11855
"POINT(-72 54)",1970,2014,44,"45",12697
"POINT(-61.56738 44.19795)",1970,1981,11,"12",12197
"POINT(-61.56738 44.19795)",1995,2016,21,"22",12563
"POINT(-63.165833 46.420833)",2011,2014,3,"2",15264
"POINT(-55.995809 46.034584)",1974,1993,19,"8",10385
"POINT(-59.348941 46.441917)",1970,1994,24,"15",10757
"POINT(-61.56738 44.19795)",1970,1981,11,"12",11323
"POINT(-74.381869 45.160229)",1998,2016,18,"5",13909
"POINT(-81.87611 45.625)",1950,1983,33,"34",13401
"POINT(-65.098835 42.729563)",1971,1994,23,"12",10891
"POINT(-74.381869 45.160229)",1984,2018,34,"10",14034
"POINT(-63.446958 46.46855)",2011,2014,3,"2",15493
"POINT(-55.995809 46.034584)",1974,1993,19,"10",10922
"POINT(-63.728047 47.637685)",1970,1994,24,"25",10165
"POINT(-65.50048 43.2532)",1970,1975,5,"4",11402
"POINT(-63 47)",1978,1990,12,"13",13394
"POINT(-65.098835 42.729563)",1970,1994,24,"23",10905
"POINT(-59.822611 42.550438)",1983,2008,25,"16",11246
"POINT(-69 43)",1967,1989,22,"23",13146
"POINT(-61.56738 44.19795)",1995,2016,21,"21",11437
"POINT(-72.88129 46.69751)",2017,2020,3,"3",16123
"POINT(-49.956886 45.114711)",1970,1994,24,"25",10655
"POINT(-72 54)",1970,2014,44,"45",12665
"POINT(-61.87121 45.68314)",2004,2010,6,"7",15656
"POINT(-64.646046 47.789535)",2011,2014,3,"2",15444
"POINT(-61.56738 44.19795)",1970,1981,11,"12",11590
"POINT(-73.107078 52.941847)",1970,2014,44,"45",12878
"POINT(-63.2 42)",1973,1986,13,"14",13265
"POINT(-62.067902 49.652037)",1972,1990,18,"17",10236
"POINT(-61.181309 42.866877)",1970,1994,24,"25",10659
"POINT(-74.018383 39.10066)",1967,2005,38,"39",14144
"POINT(-65.63232 43.2452)",1982,2006,24,"25",14141
"POINT(-61.56738 44.19795)",1982,1994,12,"13",12248
"POINT(-65.50048 43.2532)",1970,1981,11,"12",12157
"POINT(-68.526458 40.575228)",1982,2016,34,"35",14591
"POINT(-61.56738 44.19795)",1995,2016,21,"22",12556
"POINT(-57.690888 43.437611)",1970,1994,24,"24",10615
"POINT(-74.018383 39.10066)",1975,2005,30,"31",14245
"POINT(-77.229936 44.152886)",1992,2012,20,"21",13503
"POINT(-72.82857 45.04889)",2016,2021,5,"3",16071
"POINT(-62.067902 49.652037)",1977,1994,17,"11",10732
"POINT(-65.50048 43.2532)",1982,1994,12,"13",11398
"POINT(-77.72313 43.99472)",2008,2015,7,"2",13788
"POINT(-67.064717 44.266029)",1979,1990,11,"4",10566
"POINT(-63.728047 47.637685)",1972,1994,22,"23",10869
"POINT(-79.11 43.05)",1994,2007,13,"14",14823
"POINT(-63.902612 46.237205)",2001,2003,2,"3",10081
"POINT(-61.56738 44.19795)",1995,2016,21,"22",11709
"POINT(-61.56738 44.19795)",1982,1994,12,"13",12557
"POINT(-53.236883 48.747752)",1988,2009,21,"22",11257
"POINT(-62.735984 45.290147)",1970,2014,44,"45",12706
"POINT(-65.50048 43.2532)",1995,2016,21,"22",11499
"POINT(-77.072526 44.096244)",1992,2012,20,"21",13560
"POINT(-61.181309 42.866877)",1982,1987,5,"5",11032
"POINT(-77.229936 44.152886)",1992,2018,26,"27",13941
"POINT(-68.615921 41.275324)",1963,2009,46,"47",14597
"POINT(-61.56738 44.19795)",1982,1994,12,"9",12278
"POINT(-61.56738 44.19795)",1983,1993,10,"8",12320
"POINT(-65.50048 43.2532)",1990,1994,4,"2",12486
"POINT(-71.71751 46.41901)",2016,2021,5,"6",16140
"POINT(-77.229936 44.152886)",1992,2018,26,"27",13718
"POINT(-65.562778 46.995278)",2011,2014,3,"2",15250
"POINT(-48.319336 48.138699)",1996,2010,14,"15",14924
"POINT(-68.615921 41.275324)",1963,2016,53,"54",14680
"POINT(-76.80115 45.46877)",2010,2011,1,"2",11170
"POINT(-72.82857 45.04889)",2016,2021,5,"3",15964
"POINT(-53.864595 53.910492)",1978,1991,13,"4",10987
"POINT(-77.229936 44.152886)",1992,2018,26,"27",13720
"POINT(-68.615921 41.275324)",1963,2005,42,"43",14374
"POINT(-62.11238 46.383134)",2004,2010,6,"7",15101
"POINT(-61.56738 44.19795)",1970,1981,11,"12",11781
"POINT(-74.381869 45.160229)",1990,2018,28,"3",13931
"POINT(-67.064717 44.266029)",1971,1994,23,"19",10504
"POINT(-86 50)",1970,2014,44,"45",12830
"POINT(-61.56738 44.19795)",1982,1994,12,"13",11564
"POINT(-65.50048 43.2532)",1970,1981,11,"12",11882
"POINT(-59.348941 46.441917)",1986,1994,8,"3",10888
"POINT(-77.22225 44.149251)",2001,2015,14,"14",13786
"POINT(-77.59299 44.01301)",2001,2015,14,"3",13876
"POINT(-77.72313 43.99472)",2008,2015,7,"2",13873
"POINT(-63.2 42)",1973,1986,13,"14",13349
"POINT(-74.381869 45.160229)",1984,2016,32,"15",13643
"POINT(-63.888896 46.512101)",2011,2014,3,"2",15675
"POINT(-65.098835 42.729563)",1970,1994,24,"23",10941
"POINT(-78.523333 45.595278)",1952,1995,43,"43",11279
"POINT(-52 50)",1962,1992,30,"31",13147
"POINT(-65.50048 43.2532)",1995,2016,21,"22",11740
"POINT(-63.14804 46.23122)",2006,2010,4,"3",15221
"POINT(-65.098835 42.729563)",1979,1986,7,"6",10800
"POINT(-61.56738 44.19795)",1982,1994,12,"13",11856
"POINT(-58.452138 49.69674)",1975,1994,19,"17",10849
"POINT(-66.089296 44.42804)",1999,2006,7,"8",11141
"POINT(-65.50048 43.2532)",1998,2009,11,"7",12306
"POINT(-56.383301 46.711721)",1972,1982,10,"11",14944
"POINT(-70.87637 46.85767)",2016,2020,4,"3",16161
"POINT(-72.82857 45.04889)",2016,2021,5,"3",16107
"POINT(-61.017433 46.6243)",2011,2014,3,"2",15748
"POINT(-72.88129 46.69751)",2016,2021,5,"6",16058
"POINT(-55.995809 46.034584)",1970,1994,24,"24",10850
"POINT(-63.728047 47.637685)",1972,1994,22,"23",10322
"POINT(-66.323033 46.650516)",1969,2014,45,"46",11150
"POINT(-52.782383 44.683779)",1973,1991,18,"10",10735
"POINT(-65.098835 42.729563)",1979,1986,7,"5",10390
"POINT(-51.3 44.3)",1968,1986,18,"19",13403
"POINT(-68.3 43.3)",2007,2014,7,"8",14778
"POINT(-65.50048 43.2532)",1982,1994,12,"13",12367
"POINT(-57.690888 43.437611)",1973,1994,21,"14",10730
"POINT(-74.58861 36.44722)",1981,2008,27,"28",14353
"POINT(-61.56738 44.19795)",1970,1981,11,"9",12452
"POINT(-55.3 46)",1959,1993,34,"35",13369
"POINT(-50.370609 48.414273)",1977,2000,23,"24",14118
"POINT(-65.50048 43.2532)",1970,1981,11,"12",11479
"POINT(-63.758716 46.383956)",2011,2014,3,"2",15497
"POINT(-61.181309 42.866877)",1987,1992,5,"3",10331
"POINT(-52.757812 52.054271)",1995,2009,14,"15",14860
"POINT(-65.098835 42.729563)",1980,1994,14,"6",10415
"POINT(-58.452138 49.69674)",1973,1993,20,"12",10360
"POINT(-61.455567 46.07815)",2004,2010,6,"7",15332
"POINT(-61.56738 44.19795)",1984,1993,9,"4",11345
"POINT(-72 54)",1970,2014,44,"45",12777
"POINT(-63.739472 45.85055)",2005,2009,4,"5",15322
"POINT(-65.50048 43.2532)",1970,1981,11,"12",12547
"POINT(-61.56738 44.19795)",2010,2014,4,"2",11362
"POINT(-65.63232 43.2452)",1970,2010,40,"41",14336
"POINT(-52.757812 52.054271)",1995,2009,14,"15",14933
"POINT(-52.757812 52.054271)",1995,2009,14,"15",14908
"POINT(-65.50048 43.2532)",1970,1981,11,"11",12165
"POINT(-65.50048 43.2532)",1970,1981,11,"12",12603
"POINT(-61.56738 44.19795)",1970,1981,11,"10",12168
"POINT(-64.646046 47.789535)",2004,2010,6,"7",15333
"POINT(-61.56738 44.19795)",1995,2016,21,"22",11512
"POINT(-79.37806 44.73333)",1980,1987,7,"8",13381
"POINT(-72.88129 46.69751)",2017,2021,4,"5",15992
"POINT(-79.85068 43.28331)",2008,2014,6,"2",13790
"POINT(-52.782383 44.683779)",1975,1994,19,"15",10410
"POINT(-50 43.083333)",2001,2011,10,"11",13434
"POINT(-64.126831 46.773778)",2004,2010,6,"7",15217
"POINT(-61.56738 44.19795)",1970,1981,11,"12",12211
"POINT(-51.3 44.3)",1968,1986,18,"19",13298
"POINT(-52.782383 44.683779)",1976,1994,18,"13",11046
"POINT(-77.22225 44.149251)",2001,2015,14,"10",13817
"POINT(-61.56738 44.19795)",1982,1994,12,"13",11824
"POINT(-53.37158 51.46769)",1979,2011,32,"33",14553
"POINT(-66.75 46.5)",1970,2014,44,"45",12670
"POINT(-56.9199 48.84746)",2015,2016,1,"2",11309
"POINT(-65.50048 43.2532)",1995,2016,21,"21",12184
"POINT(-61.56738 44.19795)",1970,1981,11,"12",12196
"POINT(-62.735984 45.290147)",1970,2014,44,"45",12814
"POINT(-74.381869 45.160229)",1984,2018,34,"17",13753
"POINT(-61.455567 46.07815)",2004,2010,6,"7",15722
"POINT(-64.710486 46.475972)",2011,2014,3,"2",15507
"POINT(-65.50048 43.2532)",1995,2014,19,"17",11549
"POINT(-61.56738 44.19795)",1995,2016,21,"21",11484
"POINT(-63 47)",1984,2004,20,"19",11228
"POINT(-84.499722 49.25)",1995,2006,11,"12",9964
"POINT(-64.873712 47.473463)",2011,2014,3,"2",15348
"POINT(-52.782383 44.683779)",1979,1993,14,"4",10453
"POINT(-65.63232 43.2452)",1980,2008,28,"29",14180
"POINT(-77.547686 43.947746)",1992,2018,26,"27",13749
"POINT(-71.093778 40.671798)",1989,2016,27,"28",14545
"POINT(-64.56477 46.273319)",2011,2014,3,"2",15665
"POINT(-80.98194 43.37)",1992,1994,2,"3",13011
"POINT(-76.794435 44.062208)",1992,2018,26,"27",13740
"POINT(-61.56738 44.19795)",1982,1994,12,"13",11531
"POINT(-61.56738 44.19795)",1970,1981,11,"12",12478
"POINT(-59.853639 59.286076)",1978,1988,10,"4",10488
"POINT(-86 50)",1970,2014,44,"45",12840
"POINT(-65.50048 43.2532)",1995,2016,21,"22",12026
"POINT(-72.88129 46.69751)",2016,2021,5,"6",16170
"POINT(-61.56738 44.19795)",1996,2016,20,"14",11329
"POINT(-65.63232 43.2452)",1970,2007,37,"38",14204
"POINT(-57.690888 43.437611)",1970,1990,20,"4",10632
"POINT(-70.87637 46.85767)",2018,2019,1,"2",16207
"POINT(-61.56738 44.19795)",1982,1994,12,"13",12599
"POINT(-65.029957 47.777114)",2011,2014,3,"2",15619
"POINT(-57.66043 53.1355)",1999,2014,15,"16",12743
"POINT(-57.690888 43.437611)",1973,1991,18,"14",10233
"POINT(-74.018383 39.10066)",1971,2016,45,"46",14648
"POINT(-58.02978 50.13466)",1973,2003,30,"31",14242
"POINT(-58.02978 50.13466)",1973,2003,30,"31",14167
"POINT(-79.37806 44.73333)",1980,1987,7,"8",13339
"POINT(-61.181309 42.866877)",1982,1987,5,"5",10319
"POINT(-64.873712 47.473463)",2011,2014,3,"2",15235
"POINT(-67.064717 44.266029)",1971,1994,23,"20",11010
"POINT(-63.728047 47.637685)",1972,1994,22,"6",10715
"POINT(-65.50048 43.2532)",1995,2016,21,"22",11585
"POINT(-64.11454 46.1827)",2009,2010,1,"2",15802
"POINT(-56.766309 56.477534)",1977,1991,14,"9",10686
"POINT(-58.93 43.84)",1988,2011,23,"18",15845
"POINT(-72.47958 46.88236)",2016,2021,5,"2",16200
"POINT(-63.739472 45.85055)",2007,2008,1,"2",15452
"POINT(-58.635512 47.364248)",1971,1994,23,"23",11058
"POINT(-61.56738 44.19795)",1996,2016,20,"11",12487
"POINT(-65.50048 43.2532)",1970,1981,11,"12",12424
"POINT(-61.56738 44.19795)",1977,1981,4,"4",11661
"POINT(-79.85068 43.28331)",2006,2014,8,"5",13878
"POINT(-65.031944 45.616667)",1995,1996,1,"2",9938
"POINT(-77.547686 43.947746)",1992,2018,26,"27",13628
"POINT(-61.56738 44.19795)",1995,2016,21,"22",11839
"POINT(-65.50048 43.2532)",1982,1994,12,"13",12404
"POINT(-55.995809 46.034584)",1976,1980,4,"3",10301
"POINT(-56.766309 56.477534)",1977,1991,14,"8",10791
"POINT(-61.56738 44.19795)",1970,1981,11,"12",12024
"POINT(-65.50048 43.2532)",1995,2016,21,"22",12274
"POINT(-65.50048 43.2532)",1970,1981,11,"12",12336
"POINT(-61.56738 44.19795)",1970,1981,11,"12",12537
"POINT(-66.75 46.5)",1970,2014,44,"45",12674
"POINT(-77.547686 43.947746)",1992,2018,26,"27",14007
"POINT(-68.526458 40.575228)",1982,2016,34,"35",14507
"POINT(-53.766667 49.583333)",1973,2001,28,"4",14807
"POINT(-77.59299 44.01301)",2001,2015,14,"3",13857
"POINT(-64.710486 46.475972)",2004,2010,6,"2",15803
"POINT(-81.856583 42.276928)",2004,2008,4,"4",11161
"POINT(-53.864595 53.910492)",1970,1994,24,"24",10685
"POINT(-61.56738 44.19795)",1970,1981,11,"12",11552
"POINT(-74.381869 45.160229)",2000,2016,16,"5",13981
"POINT(-68.615921 41.275324)",1963,2005,42,"43",14172
"POINT(-65.50048 43.2532)",1982,1994,12,"13",12126
"POINT(-72.88129 46.69751)",2016,2021,5,"5",16216
"POINT(-73.107078 52.941847)",1970,2014,44,"45",12803
"POINT(-71.093778 40.671798)",1968,2006,38,"39",14352
"POINT(-48.319336 48.138699)",1984,1995,11,"12",14973
"POINT(-62.916667 47.416667)",1971,2012,41,"42",15040
"POINT(-72 54)",1970,2014,44,"45",12792
"POINT(-65.50048 43.2532)",1982,1994,12,"13",12204
"POINT(-72.82857 45.04889)",2016,2021,5,"3",16010
"POINT(-56.766309 56.477534)",1978,1991,13,"7",10397
"POINT(-61.56738 44.19795)",1997,2016,19,"20",12015
"POINT(-51.3 44.3)",1959,2013,54,"55",13425
"POINT(-61.87121 45.68314)",2011,2014,3,"2",15311
"POINT(-71.71751 46.41901)",2016,2021,5,"6",15907
"POINT(-61.56738 44.19795)",1982,1994,12,"13",11447
"POINT(-57.690888 43.437611)",1983,1993,10,"8",10858
"POINT(-58.93 43.84)",1988,2011,23,"18",15844
"POINT(-79.37806 44.73333)",1980,1987,7,"8",13318
"POINT(-65.50048 43.2532)",1995,2005,10,"2",12173
"POINT(-64.11454 46.1827)",2009,2010,1,"2",15536
"POINT(-52.782383 44.683779)",1970,1994,24,"22",10913
"POINT(-58.452138 49.69674)",1971,1994,23,"23",10308
"POINT(-68.615921 41.275324)",1970,2016,46,"47",14626
"POINT(-72.88129 46.69751)",2017,2019,2,"2",16007
"POINT(-63.758716 46.383956)",2008,2010,2,"2",15786
"POINT(-70.87637 46.85767)",2018,2021,3,"4",15890
"POINT(-65.50048 43.2532)",1995,2016,21,"22",12119
"POINT(-52.121122 50.695322)",1970,1994,24,"24",10928
"POINT(-62.511072 46.018891)",2011,2014,3,"2",15739
"POINT(-53.864595 53.910492)",1971,1985,14,"7",11105
"POINT(-57.690888 43.437611)",1970,1994,24,"18",10756
"POINT(-65.50048 43.2532)",1970,1981,11,"12",11963
"POINT(-64.646046 47.789535)",2004,2010,6,"5",15646
"POINT(-68.615921 41.275324)",1970,2016,46,"47",14598
"POINT(-61.56738 44.19795)",1984,1993,9,"4",11612
"POINT(-61.455567 46.07815)",2006,2009,3,"2",15711
"POINT(-61.56738 44.19795)",1970,1981,11,"9",11384
"POINT(-68.615921 41.275324)",1963,2005,42,"43",14274
"POINT(-77.072526 44.096244)",1992,2018,26,"27",13724
"POINT(-79.85068 43.28331)",2006,2015,9,"6",13888
"POINT(-65.50048 43.2532)",1995,2016,21,"22",12567
"POINT(-74.018383 39.10066)",1975,2005,30,"31",14170
"POINT(-78.131111 40.616944)",1986,2010,24,"25",12986
"POINT(-62.067902 49.652037)",1973,1994,21,"17",10572
"POINT(-72.82857 45.04889)",2019,2021,2,"2",16163
"POINT(-70.87637 46.85767)",2017,2020,3,"2",15880
"POINT(-64.965766 47.341712)",2005,2010,5,"4",15556
"POINT(-63 47)",1971,2016,45,"44",10062
"POINT(-61.56738 44.19795)",1970,1981,11,"9",11520
"POINT(-72.47958 46.88236)",2016,2021,5,"2",16092
"POINT(-52.782383 44.683779)",1988,1994,6,"5",10970
"POINT(-61.87121 45.68314)",2002,2003,1,"2",15578
"POINT(-63.14804 46.23122)",2011,2014,3,"2",15380
"POINT(-74.018383 39.10066)",1982,2015,33,"34",14621
"POINT(-72 54)",1970,2014,44,"45",12797
"POINT(-53.864595 53.910492)",1971,1994,23,"18",10699
"POINT(-63.06152 46.75491)",1978,2018,40,"41",14607
"POINT(-61.56738 44.19795)",1998,2009,11,"3",11574
"POINT(-72 54)",1970,2014,44,"45",12779
"POINT(-71.71751 46.41901)",2016,2021,5,"6",16066
"POINT(-61.56738 44.19795)",1982,1994,12,"13",12264
"POINT(-68.871657 43.27657)",1985,2016,31,"32",14743
"POINT(-61.56738 44.19795)",1997,2016,19,"20",11481
"POINT(-62.511072 46.018891)",2005,2010,5,"6",15328
"POINT(-64.8083 47.67109)",2011,2014,3,"2",15371
"POINT(-72.47958 46.88236)",2016,2021,5,"2",16134
"POINT(-61.56738 44.19795)",1995,2016,21,"22",12368
"POINT(-77.22225 44.149251)",2001,2015,14,"14",13895
"POINT(-61.56738 44.19795)",1999,2014,15,"9",11373
"POINT(-55.995809 46.034584)",1975,1986,11,"6",11101
"POINT(-55.995809 46.034584)",1975,1986,11,"7",10229
"POINT(-78.5 45.58333)",1977,1988,11,"12",10121
"POINT(-61.181309 42.866877)",1970,1994,24,"25",11059
"POINT(-73.795833 45.016389)",2003,2004,1,"2",13078
"POINT(-52.757812 52.054271)",1977,1994,17,"18",14936
"POINT(-64.710486 46.475972)",2007,2010,3,"3",15697
"POINT(-75.98472 44.35056)",1983,1996,13,"14",15840
"POINT(-58.02978 50.13466)",1973,2003,30,"31",14142
"POINT(-61.56738 44.19795)",1970,1981,11,"12",12359
"POINT(-63 47)",1982,2005,23,"12",10016
"POINT(-56.18528 45.904453)",2005,2008,3,"4",11240
"POINT(-79.361398 43.62142)",2006,2012,6,"4",13497
"POINT(-60.3 44.1)",1967,1990,23,"24",13395
"POINT(-50.370609 48.414273)",1977,2000,23,"24",14343
"POINT(-66.11572 44.8247)",1997,2012,15,"16",14605
"POINT(-65.098835 42.729563)",1970,1994,24,"24",10219
"POINT(-68.615921 41.275324)",1963,2016,53,"54",14736
"POINT(-77.72313 43.99472)",2008,2015,7,"2",13780
"POINT(-74.381869 45.160229)",1984,2008,24,"5",13933
"POINT(-58.635512 47.364248)",1977,1994,17,"3",10637
"POINT(-56.383301 46.711721)",1984,1995,11,"12",14917
"POINT(-65.098835 42.729563)",1985,1987,2,"3",10856
"POINT(-61.56738 44.19795)",1982,1994,12,"6",11573
"POINT(-56.383301 46.711721)",1984,1991,7,"5",14870
"POINT(-67.5 40.4)",1955,1987,32,"33",13362
"POINT(-63.758716 46.383956)",2007,2010,3,"4",15272
"POINT(-48.33984 44.59046)",1977,2000,23,"24",14237
"POINT(-59.348941 46.441917)",1980,1994,14,"3",10814
"POINT(-66.11572 44.8247)",1997,2012,15,"16",14717
"POINT(-61.181309 42.866877)",1971,1994,23,"13",10470
"POINT(-65.3 43)",1970,1997,27,"28",13260
"POINT(-76.06 44.055)",1976,2016,40,"41",13056
"POINT(-64.873712 47.473463)",2005,2010,5,"3",15784
"POINT(-62.735984 45.290147)",1970,2014,44,"45",12810
"POINT(-65.50048 43.2532)",1995,2016,21,"22",11931
"POINT(-61.56738 44.19795)",1985,1994,9,"4",12576
"POINT(-63.06152 46.75491)",1978,2018,40,"41",14467
"POINT(-79.361398 43.62142)",2006,2012,6,"4",13517
"POINT(-61.56738 44.19795)",1970,1981,11,"12",11472
"POINT(-55.995809 46.034584)",1970,1994,24,"14",10718
"POINT(-68.871657 43.27657)",1985,2016,31,"32",14687
"POINT(-55.995809 46.034584)",1972,1994,22,"11",10558
"POINT(-79.361398 43.62142)",2006,2012,6,"4",13471
"POINT(-65.50048 43.2532)",1995,2016,21,"22",11404
"POINT(-52.782383 44.683779)",1978,1994,16,"16",10696
"POINT(-65.63232 43.2452)",1970,2007,37,"38",14129
"POINT(-68.615921 41.275324)",1970,2016,46,"47",14542
"POINT(-63.728047 47.637685)",1983,1991,8,"3",11041
"POINT(-61.56738 44.19795)",1995,2016,21,"22",12252
"POINT(-82.517801 41.970728)",2002,2003,1,"2",15006
"POINT(-47.89333 50.44083)",1983,2018,35,"36",14390
"POINT(-72.88129 46.69751)",2016,2021,5,"5",16137
"POINT(-52.757812 52.054271)",1995,2009,14,"15",14883
"POINT(-65.562778 46.995278)",2004,2010,6,"6",15642
"POINT(-66.089296 44.42804)",1999,2006,7,"8",11139
"POINT(-63.06152 46.75491)",1978,2018,40,"41",14466
"POINT(-72.88129 46.69751)",2016,2021,5,"6",15916
"POINT(-82.517801 41.970728)",2002,2003,1,"2",15031
"POINT(-56.383301 46.711721)",1996,2010,14,"14",14938
"POINT(-62.28626 46.36766)",2011,2014,3,"2",15663
"POINT(-59.853639 59.286076)",1978,1991,13,"4",10724
"POINT(-65.098835 42.729563)",1972,1994,22,"17",10803
"POINT(-65.50048 43.2532)",1996,2016,20,"12",12377
"POINT(-63.126667 46.235)",1998,1999,1,"2",14975
"POINT(-77.22225 44.149251)",2001,2015,14,"14",13819
"POINT(-64.710486 46.475972)",2011,2014,3,"2",15473
"POINT(-77.80861 43.698439)",1997,2012,15,"14",13567
"POINT(-61.56738 44.19795)",1970,1981,11,"12",11624
"POINT(-63.902612 46.237205)",2001,2006,5,"6",10083
"POINT(-65.50048 43.2532)",1995,2016,21,"22",12507
"POINT(-65.50048 43.2532)",1970,1981,11,"11",12267
"POINT(-84.52551 50.219196)",2016,2017,1,"2",14989
"POINT(-61.56738 44.19795)",1982,1994,12,"13",12059
"POINT(-65.029957 47.777114)",2004,2010,6,"7",15125
"POINT(-79.361398 43.62142)",2006,2012,6,"4",13480
"POINT(-53.172992 49.757443)",1995,2012,17,"18",11289
"POINT(-59 49.25)",1965,2017,52,"53",14696
"POINT(-78.523333 45.595278)",1972,1991,19,"19",12964
"POINT(-61.56738 44.19795)",1995,2016,21,"22",11797
"POINT(-65.50048 43.2532)",1995,2016,21,"21",11886
"POINT(-77.229936 44.152886)",1992,2018,26,"27",13711
"POINT(-67 41)",1950,1998,48,"49",13343
"POINT(-74.58861 36.44722)",1981,2008,27,"28",14328
"POINT(-61.56738 44.19795)",1970,1981,11,"12",12333
"POINT(-74.018383 39.10066)",1973,2002,29,"30",14296
"POINT(-56 55)",1970,1985,15,"2",13116
"POINT(-67.506713 41.1087)",1987,2008,21,"22",11248
"POINT(-61.56738 44.19795)",1995,2010,15,"11",12426
"POINT(-61.164851 45.857738)",1996,1997,1,"2",14095
"POINT(-77.954487 62.570058)",1980,2004,24,"8",12969
"POINT(-65.50048 43.2532)",1995,2016,21,"22",12498
"POINT(-73.354283 51.290389)",1970,2014,44,"45",11147
"POINT(-61.181309 42.866877)",1979,1987,8,"7",10391
"POINT(-61.56738 44.19795)",1995,2015,20,"12",11361
"POINT(-79.3 45.0333)",1972,1991,19,"20",12942
"POINT(-65.50048 43.2532)",1995,2016,21,"22",11374
"POINT(-73.107078 52.941847)",1970,2014,44,"45",12812
"POINT(-61.56738 44.19795)",1982,1994,12,"13",12525
"POINT(-69 43)",1967,1989,22,"23",13209
"POINT(-64.861867 46.665292)",2011,2014,3,"2",15734
"POINT(-58.452138 49.69674)",1973,1994,21,"18",10268
"POINT(-71.093778 40.671798)",1982,2012,30,"31",14326
"POINT(-65.50048 43.2532)",1985,1993,8,"2",11386
"POINT(-61.56738 44.19795)",1982,1994,12,"13",12167
"POINT(-65.50048 43.2532)",1982,1994,12,"13",12523
"POINT(-65.50048 43.2532)",1970,1978,8,"6",11914
"POINT(-64.573724 46.34102)",2004,2010,6,"7",15488
"POINT(-62.28626 46.36766)",2008,2010,2,"3",15318
"POINT(-53.864595 53.910492)",1970,1994,24,"24",10517
"POINT(-65.08333 43.16667)",1999,2001,2,"3",10002
"POINT(-65.50048 43.2532)",1995,2016,21,"22",11420
"POINT(-72.88129 46.69751)",2016,2021,5,"4",16132
"POINT(-61.56738 44.19795)",1970,1981,11,"10",11901
"POINT(-65.50048 43.2532)",1970,1981,11,"12",12280
"POINT(-64.126831 46.773778)",2004,2010,6,"7",15086
"POINT(-69.665 47.78333)",1994,2000,6,"7",15825
"POINT(-65.3 43)",1971,2007,36,"37",11236
"POINT(-62.74132 45.67583)",2011,2014,3,"2",15373
"POINT(-81.252288 42.209417)",1990,2012,22,"23",13110
"POINT(-65.50048 43.2532)",1995,2016,21,"22",11397
"POINT(-67.064717 44.266029)",1971,1993,22,"13",10601
"POINT(-51.3 44.3)",1968,1986,18,"19",13130
"POINT(-62.90725 46.058533)",2011,2014,3,"2",15712
"POINT(-65.50048 43.2532)",1995,2016,21,"22",11782
"POINT(-61.56738 44.19795)",1982,1994,12,"13",12258
"POINT(-58.635512 47.364248)",1973,1993,20,"18",10270
"POINT(-68.615921 41.275324)",1963,2005,42,"43",14397
"POINT(-61.181309 42.866877)",1970,1994,24,"25",10162
"POINT(-64.126831 46.773778)",2011,2014,3,"2",15251
"POINT(-64.657552 47.746584)",2011,2014,3,"2",15168
"POINT(-72.47958 46.88236)",2016,2021,5,"2",16188
"POINT(-65.50048 43.2532)",1995,2016,21,"16",11951
"POINT(-63.277839 64.284513)",2005,2008,3,"4",14987
"POINT(-63.888896 46.512101)",2011,2014,3,"2",15296
"POINT(-72.47958 46.88236)",2016,2021,5,"2",15877
"POINT(-71.772245 43.931185)",2012,2018,6,"5",13087
"POINT(-61.56738 44.19795)",1995,2016,21,"22",12389
"POINT(-61.56738 44.19795)",1982,1994,12,"13",11981
"POINT(-61.181309 42.866877)",1970,1994,24,"25",10828
"POINT(-72.47958 46.88236)",2016,2021,5,"2",16033
"POINT(-66.214847 41.627502)",1991,1993,2,"3",11086
"POINT(-52.121122 50.695322)",1974,1990,16,"5",10711
"POINT(-65.50048 43.2532)",1982,1994,12,"13",11989
"POINT(-64.126831 46.773778)",2004,2010,6,"5",15643
"POINT(-52.121122 50.695322)",1981,1994,13,"7",11006
"POINT(-64.56477 46.273319)",2008,2009,1,"2",15561
"POINT(-57.690888 43.437611)",1970,1994,24,"25",10603
"POINT(-77.72313 43.99472)",2008,2015,7,"2",13795
"POINT(-56.766309 56.477534)",1977,1991,14,"8",11050
"POINT(-58.452138 49.69674)",1971,1994,23,"21",10607
"POINT(-65.098835 42.729563)",1970,1994,24,"25",10224
"POINT(-65.50048 43.2532)",1982,1994,12,"13",12068
"POINT(-74.381869 45.160229)",1984,2018,34,"17",13692
"POINT(-71.71751 46.41901)",2016,2019,3,"4",16143
"POINT(-63.2 42)",1973,1986,13,"14",13223
"POINT(-64.965766 47.341712)",2007,2010,3,"4",15055
"POINT(-64.554866 46.218937)",2011,2014,3,"2",15171
"POINT(-61.181309 42.866877)",1970,1994,24,"25",11070
"POINT(-72.82857 45.04889)",2016,2021,5,"3",15991
"POINT(-83.05 42.033333)",1975,2004,29,"29",12892
"POINT(-62.11238 46.383134)",2011,2014,3,"2",15436
"POINT(-53.864595 53.910492)",1971,1986,15,"3",10503
"POINT(-61.56738 44.19795)",1995,2016,21,"22",11659
"POINT(-63 47)",1978,1990,12,"13",13246
"POINT(-62.067902 49.652037)",1973,1994,21,"20",11074
"POINT(-70.42472 47.26306)",1994,2000,6,"7",15826
"POINT(-72.88129 46.69751)",2017,2020,3,"3",15953
"POINT(-66.75 46.5)",1970,2014,44,"45",12841
"POINT(-58.635512 47.364248)",1972,1994,22,"12",10681
"POINT(-65.50048 43.2532)",1995,2016,21,"22",11988
"POINT(-52.757812 52.054271)",1995,2009,14,"15",14884
"POINT(-73.107078 52.941847)",1970,2014,44,"45",12700
"POINT(-65.50048 43.2532)",1984,1994,10,"10",12345
"POINT(-55.225157 50.548819)",1969,2010,41,"15",12970
"POINT(-52.121122 50.695322)",1970,1991,21,"15",10821
"POINT(-63 47)",1978,1990,12,"13",13331
"POINT(-61.56738 44.19795)",1995,2016,21,"22",12433
"POINT(-61.56738 44.19795)",1970,1981,11,"12",12158
"POINT(-61.56738 44.19795)",1995,2016,21,"22",11762
"POINT(-70.87637 46.85767)",2016,2021,5,"6",15908
"POINT(-69.666667 48.15)",1994,2005,11,"12",12902
"POINT(-72.88129 46.69751)",2016,2021,5,"6",15960
"POINT(-48.319336 48.138699)",1984,1995,11,"12",14949
"POINT(-86 50)",1970,2014,44,"45",12852
"POINT(-61.56738 44.19795)",2002,2016,14,"13",11648
"POINT(-61.56738 44.19795)",1982,1994,12,"13",11496
"POINT(-74.381869 45.160229)",1984,2008,24,"5",13975
"POINT(-72.88129 46.69751)",2016,2021,5,"6",15993
"POINT(-61.56738 44.19795)",1988,1994,6,"3",11600
"POINT(-77.229936 44.152886)",1992,2018,26,"27",13702
"POINT(-74.381869 45.160229)",1984,2018,34,"17",13642
"POINT(-62.90725 46.058533)",2011,2014,3,"2",15670
"POINT(-61.56738 44.19795)",1970,1981,11,"12",12616
"POINT(-65.50048 43.2532)",1982,1994,12,"13",11795
"POINT(-86 50)",1970,2014,44,"45",12773
"POINT(-68.526458 40.575228)",1982,2016,34,"35",14647
"POINT(-58.452138 49.69674)",1970,1994,24,"24",10619
"POINT(-65.50048 43.2532)",1982,1994,12,"13",12323
"POINT(-66.214847 41.627502)",1980,1993,13,"11",10200
"POINT(-59 44.1)",1976,1990,14,"15",13132
"POINT(-61.181309 42.866877)",1970,1994,24,"25",10844
"POINT(-69 43)",1967,1989,22,"23",13355
"POINT(-65.50048 43.2532)",1995,2016,21,"22",11961
"POINT(-74.381869 45.160229)",2012,2018,6,"4",13998
"POINT(-53.864595 53.910492)",1970,1994,24,"24",10155
"POINT(-72.47958 46.88236)",2016,2021,5,"2",16060
"POINT(-72.47958 46.88236)",2016,2021,5,"2",16115
"POINT(-72 40)",1973,2016,43,"44",14473
"POINT(-58.452138 49.69674)",1970,1994,24,"24",11075
"POINT(-76.06 44.055)",1980,1992,12,"3",13037
"POINT(-49.956886 45.114711)",1971,1994,23,"18",10697
"POINT(-65.50048 43.2532)",1982,1994,12,"13",11821
"POINT(-69 43)",1967,1989,22,"23",13251
"POINT(-74.018383 39.10066)",1968,2011,43,"44",14482
"POINT(-65.50048 43.2532)",1982,1994,12,"13",11486
"POINT(-65.50048 43.2532)",1982,1994,12,"13",11937
"POINT(-52.757812 52.054271)",1995,2009,14,"15",14931
"POINT(-71.093778 40.671798)",1968,2006,38,"39",14277
"POINT(-65.50048 43.2532)",1982,1994,12,"13",11672
"POINT(-65.50048 43.2532)",1971,1979,8,"3",11845
"POINT(-57.00011 50.62045)",2015,2016,1,"2",11311
"POINT(-58.452138 49.69674)",1983,1994,11,"12",10881
"POINT(-67 44)",1991,1999,8,"4",11156
"POINT(-60.79843 53.003392)",1974,2014,40,"41",12815
"POINT(-59.348941 46.441917)",1985,1993,8,"3",10859
"POINT(-65.50048 43.2532)",1970,1981,11,"12",11894
"POINT(-52.121122 50.695322)",1983,1993,10,"10",10624
"POINT(-53.864595 53.910492)",1978,1994,16,"11",10486
"POINT(-71.71751 46.41901)",2017,2020,3,"2",16222
"POINT(-62.90725 46.058533)",2011,2014,3,"2",15372
"POINT(-74.018383 39.10066)",1971,2016,45,"46",14564
"POINT(-61.56738 44.19795)",1999,2014,15,"9",12441
"POINT(-64.8083 47.67109)",2011,2014,3,"2",15174
"POINT(-67 41)",1950,1998,48,"49",13301
"POINT(-66.214847 41.627502)",1980,1993,13,"10",10337
"POINT(-52.782383 44.683779)",1970,1982,12,"6",10441
"POINT(-65.090012 44.451082)",1996,1997,1,"2",14070
"POINT(-66.214847 41.627502)",1981,1993,12,"8",10612
"POINT(-65.50048 43.2532)",1982,1994,12,"13",11870
"POINT(-57.771263 49.761184)",1971,2011,40,"41",11293
"POINT(-86 50)",1970,2014,44,"45",12698
"POINT(-77.59299 44.01301)",2001,2015,14,"3",13771
"POINT(-61.56738 44.19795)",1995,2016,21,"19",11546
"POINT(-61.56738 44.19795)",1995,2016,21,"22",12296
"POINT(-68.3 43.3)",2007,2014,7,"8",14666
"POINT(-74.018383 39.10066)",1967,2005,38,"39",14369
"POINT(-77.547686 43.947746)",1992,2018,26,"27",13745
"POINT(-63.188167 45.760967)",2011,2014,3,"2",15659
"POINT(-66.46191 46.56531)",1970,2014,44,"45",12938
"POINT(-77.072526 44.096244)",1992,2018,26,"27",13666
"POINT(-65.50048 43.2532)",1982,1994,12,"13",11325
"POINT(-61.56738 44.19795)",1970,1981,11,"12",12594
"POINT(-68.871657 43.27657)",1985,2016,31,"32",14519
"POINT(-63.14804 46.23122)",2011,2014,3,"2",15165
"POINT(-71.71751 46.41901)",2016,2021,5,"5",15885
"POINT(-79.361398 43.62142)",2006,2012,6,"4",13544
"POINT(-65.50048 43.2532)",2000,2015,15,"14",11848
"POINT(-61.56738 44.19795)",1983,1994,11,"11",11316
"POINT(-62.067902 49.652037)",1973,1989,16,"11",11042
"POINT(-63.66575 45.8547)",2004,2010,6,"7",15637
"POINT(-65.50048 43.2532)",1983,1994,11,"4",12447
"POINT(-69.041914 40.95268)",1967,2014,47,"48",14421
"POINT(-77.229936 44.152886)",1992,2018,26,"27",13651
"POINT(-63.728047 47.637685)",1970,1994,24,"25",10535
"POINT(-57.690888 43.437611)",1974,1987,13,"6",10921
"POINT(-60.79843 53.003392)",1979,2014,35,"36",12874
"POINT(-48.319336 48.138699)",1996,2010,14,"15",14876
"POINT(-58.452138 49.69674)",1973,1994,21,"15",10733
"POINT(-62.28626 46.36766)",2009,2010,1,"2",15631
"POINT(-65.50048 43.2532)",1970,1981,11,"12",12467
"POINT(-72.88129 46.69751)",2016,2021,5,"6",16079
"POINT(-63 47)",1971,2016,45,"45",10031
"POINT(-52.121122 50.695322)",1973,1994,21,"7",10412
"POINT(-65.63232 43.2452)",1982,2006,24,"25",14191
"POINT(-73.107078 52.941847)",1970,2014,44,"45",12872
"POINT(-61.56738 44.19795)",1977,1981,4,"4",12195
"POINT(-69.666667 48.15)",1994,2005,11,"12",12922
"POINT(-61.56738 44.19795)",1970,1981,11,"12",12565
"POINT(-63 45)",1970,2011,41,"42",12746
"POINT(-56.766309 56.477534)",1978,1991,13,"6",10388
"POINT(-61.455567 46.07815)",2011,2014,3,"2",15253
"POINT(-61.56738 44.19795)",1995,2016,21,"19",12347
"POINT(-77.22225 44.149251)",2001,2015,14,"14",13592
"POINT(-64.951922 46.75123)",2011,2014,3,"2",15352
"POINT(-84.499722 49.25)",1995,2006,11,"12",9970
"POINT(-71.8505 46.66598)",2009,2013,4,"4",11169
"POINT(-52.757812 52.054271)",1977,1994,17,"18",14886
"POINT(-50.3 44.3)",1965,1986,21,"22",13263
"POINT(-79.361398 43.62142)",2006,2012,6,"4",13496
"POINT(-61.017433 46.6243)",2011,2014,3,"2",15151
"POINT(-63.165833 46.420833)",2011,2014,3,"2",15435
"POINT(-61.164851 45.857738)",1995,1997,2,"3",14057
"POINT(-65.50048 43.2532)",1996,2016,20,"12",12453
"POINT(-72.3944 45.1542)",2008,2010,2,"3",11173
"POINT(-61.56738 44.19795)",1995,2016,21,"22",11414
"POINT(-79.85068 43.28331)",2006,2015,9,"6",13799
"POINT(-61.56738 44.19795)",1970,1981,11,"12",12540
"POINT(-63.165833 46.420833)",2011,2014,3,"2",15155
"POINT(-61.56738 44.19795)",1995,2016,21,"22",12058
"POINT(-63 47)",1972,2016,44,"40",10053
"POINT(-77.72313 43.99472)",2008,2015,7,"2",13863
"POINT(-65.3 43)",1962,1988,26,"27",13198
"POINT(-62.067902 49.652037)",1973,1994,21,"18",10323
"POINT(-61.56738 44.19795)",1974,1981,7,"6",11448
"POINT(-61.56738 44.19795)",1982,1994,12,"13",12023
"POINT(-64.573724 46.34102)",2005,2007,2,"2",15427
"POINT(-65.57426 46.98624)",2011,2014,3,"2",15256
"POINT(-76.794435 44.062208)",1992,2018,26,"27",13620
"POINT(-65.50048 43.2532)",1996,2016,20,"12",11919
"POINT(-59.931111 43.934444)",1961,2010,49,"50",11264
"POINT(-65.63232 43.2452)",1970,2010,40,"41",14411
"POINT(-61.017433 46.6243)",2008,2010,2,"3",15094
"POINT(-65.50048 43.2532)",1982,1994,12,"13",12287
"POINT(-54.62116 46.964024)",1982,2009,27,"28",11256
"POINT(-71.71751 46.41901)",2016,2019,3,"2",15997
"POINT(-65.50048 43.2532)",1970,1981,11,"12",11360
"POINT(-65.098835 42.729563)",1970,1994,24,"25",10339
"POINT(-65.50048 43.2532)",1999,2013,14,"3",12513
"POINT(-70.87637 46.85767)",2017,2021,4,"3",16146
"POINT(-83.05 42.033333)",1975,2004,29,"29",12907
"POINT(-65.50048 43.2532)",1985,1993,8,"2",11920
"POINT(-70.87637 46.85767)",2016,2021,5,"6",16206
"POINT(-61.56738 44.19795)",1995,2016,21,"22",12406
"POINT(-59.853639 59.286076)",1978,1988,10,"5",10994
"POINT(-55.995809 46.034584)",1970,1994,24,"19",10809
"POINT(-61.56738 44.19795)",1970,1981,11,"12",11764
"POINT(-65.63232 43.2452)",1982,2006,24,"25",14116
"POINT(-50.28156 53.257559)",1995,2009,14,"15",14851
"POINT(-65.50048 43.2532)",1982,1994,12,"13",11946
"POINT(-52.757812 52.054271)",1995,2009,14,"15",14955
"POINT(-61.56738 44.19795)",1970,1981,11,"12",12092
"POINT(-74.018383 39.10066)",1973,2002,29,"30",14221
"POINT(-62.067902 49.652037)",1976,1994,18,"14",10815
"POINT(-70.87637 46.85767)",2016,2021,5,"6",16190
"POINT(-60.3 44.1)",1967,1990,23,"24",13354
"POINT(-52.121122 50.695322)",1970,1994,24,"22",10765
"POINT(-62.067902 49.652037)",1977,1989,12,"4",11090
"POINT(-52.813605 47.187621)",1979,1997,18,"2",14815
"POINT(-57.05 51)",1971,1995,24,"25",13358
"POINT(-74.381869 45.160229)",1988,2014,26,"3",13937
"POINT(-61.56738 44.19795)",1982,1984,2,"2",12343
"POINT(-63.06152 46.75491)",1970,2011,41,"42",14157
"POINT(-79.361398 43.62142)",2006,2012,6,"4",13462
"POINT(-64.646046 47.789535)",2011,2014,3,"2",15676
"POINT(-72.88129 46.69751)",2016,2021,5,"6",15909
"POINT(-70.67137 47.02846)",1999,2013,14,"3",11168
"POINT(-62.067902 49.652037)",1973,1994,21,"21",10955
"POINT(-64.951922 46.75123)",2011,2014,3,"2",15498
"POINT(-63.728047 47.637685)",1974,1993,19,"11",10266
"POINT(-86 50)",1970,2014,44,"45",12790
"POINT(-77.072526 44.096244)",1992,2018,26,"27",13667
"POINT(-61.56738 44.19795)",1995,2016,21,"22",12460
"POINT(-58.635512 47.364248)",1972,1993,21,"17",11045
"POINT(-68.3 43.3)",2007,2014,7,"8",14442
"POINT(-77.072526 44.096244)",1992,2018,26,"27",13617
"POINT(-85.58269 49.249515)",1981,1984,3,"4",15814
"POINT(-79.87106 44.866139)",1993,2007,14,"15",13023
"POINT(-76.794435 44.062208)",1992,2018,26,"27",14006
"POINT(-58.635512 47.364248)",1973,1993,20,"6",10835
"POINT(-74.58861 36.44722)",1985,2014,29,"30",14772
"POINT(-68.615921 41.275324)",1950,2007,57,"58",14655
"POINT(-74.381869 45.160229)",1984,2018,34,"17",13638
"POINT(-61.56738 44.19795)",1995,2016,21,"10",11808
"POINT(-77.229936 44.152886)",1992,2018,26,"27",13760
"POINT(-55.995809 46.034584)",1970,1994,24,"24",10957
"POINT(-79.85068 43.28331)",2006,2010,4,"3",13816
"POINT(-53.864595 53.910492)",1970,1994,24,"22",10781
"POINT(-61.56738 44.19795)",1982,1994,12,"13",12390
"POINT(-61.1 49.11667)",1986,2003,17,"15",11208
"POINT(-71.093778 40.671798)",1982,2012,30,"31",14176
"POINT(-65.50048 43.2532)",1970,1981,11,"6",12051
"POINT(-48.319336 48.138699)",1996,2010,14,"15",14948
"POINT(-63.06152 46.75491)",1978,2018,40,"41",14438
"POINT(-65.029957 47.777114)",2005,2007,2,"2",15429
"POINT(-64.873712 47.473463)",2005,2010,5,"6",15392
"POINT(-47.89333 50.44083)",1983,2007,24,"25",11197
"POINT(-61.87121 45.68314)",2011,2014,3,"2",15782
"POINT(-67.5 40.4)",1955,1987,32,"33",13299
"POINT(-61.56738 44.19795)",2002,2016,14,"13",12449
"POINT(-64.8083 47.67109)",2011,2014,3,"2",15359
"POINT(-61.181309 42.866877)",1978,1993,15,"6",10379
"POINT(-65.50048 43.2532)",1995,2016,21,"22",11521
"POINT(-63.2 42)",1973,1986,13,"14",13329
"POINT(-75.321761 46.145838)",1989,1997,8,"8",13071
"POINT(-79.361398 43.62142)",2006,2012,6,"4",13519
"POINT(-68.183899 43.174137)",1978,1986,8,"9",13027
"POINT(-59 49.25)",1965,2017,52,"53",14500
"POINT(-61.56738 44.19795)",1995,2016,21,"22",12475
"POINT(-61.25 45.75)",1996,1997,1,"2",14050
"POINT(-67 41)",1950,1998,48,"49",13385
"POINT(-58.452138 49.69674)",1970,1994,24,"24",10438
"POINT(-52.782383 44.683779)",1970,1994,24,"24",10540
"POINT(-65.3 43)",1970,1997,27,"28",13155
"POINT(-61.56738 44.19795)",1995,2016,21,"22",12004
"POINT(-65.50048 43.2532)",1995,2016,21,"22",11964
"POINT(-65.50048 43.2532)",1970,1981,11,"12",11487
"POINT(-77.072526 44.096244)",1992,2012,20,"21",13479
"POINT(-59 49.25)",1965,2017,52,"53",14612
"POINT(-65.62222 47.65259)",2009,2010,1,"2",15540
"POINT(-58.635512 47.364248)",1977,1994,17,"4",10527
"POINT(-61.56738 44.19795)",1995,2016,21,"22",11632
"POINT(-71.71751 46.41901)",2016,2019,3,"3",15947
"POINT(-67 43)",1970,2010,40,"41",14289
"POINT(-72.88129 46.69751)",2016,2021,5,"6",15968
"POINT(-52.757812 52.054271)",1995,2009,14,"15",14885
"POINT(-65.50048 43.2532)",1970,1981,11,"12",12562
"POINT(-52.121122 50.695322)",1970,1994,24,"21",10561
"POINT(-62.067902 49.652037)",1972,1994,22,"20",10406
"POINT(-61.56738 44.19795)",2002,2016,14,"13",11381
"POINT(-71.093778 40.671798)",1968,2006,38,"39",14402
"POINT(-61.56738 44.19795)",1977,1981,4,"4",11928
"POINT(-61.56738 44.19795)",1972,1981,9,"2",12178
"POINT(-68.615921 41.275324)",1963,2016,53,"54",14428
"POINT(-68.871657 43.27657)",1985,2016,31,"32",14435
"POINT(-77.072526 44.096244)",1992,2018,26,"27",13668
"POINT(-59 44.1)",1976,1990,14,"15",13363
"POINT(-79.361398 43.62142)",2006,2012,6,"4",13561
"POINT(-65.3 43)",1962,1988,26,"27",13261
"POINT(-63.888896 46.512101)",2011,2014,3,"2",15377
"POINT(-69.041914 40.95268)",1969,2008,39,"40",14588
"POINT(-61.652594 43.355895)",1970,2010,40,"41",11268
"POINT(-50.370609 48.414273)",1977,2000,23,"24",14368
"POINT(-71.71751 46.41901)",2016,2021,5,"3",16035
"POINT(-77.396957 43.50608)",1978,2018,40,"40",14008
"POINT(-66.214847 41.627502)",1980,1992,12,"8",10565
"POINT(-65.090012 44.451082)",1996,1997,1,"2",14078
"POINT(-55.995809 46.034584)",1984,1994,10,"7",10863
"POINT(-60.11667 44.08333)",1998,2010,12,"13",11231
"POINT(-65.50048 43.2532)",1970,1981,11,"12",12388
"POINT(-63.739472 45.85055)",2005,2009,4,"5",15766
"POINT(-52.782383 44.683779)",1973,1988,15,"5",10948
"POINT(-49.688298 48.040155)",1996,2009,13,"14",14835
"POINT(-65.50048 43.2532)",1983,1994,11,"12",11474
"POINT(-69.665 47.78333)",1994,2000,6,"7",15824
"POINT(-74.018383 39.10066)",1973,2002,29,"30",14171
"POINT(-64.573724 46.34102)",2004,2010,6,"7",15123
"POINT(-77.072526 44.096244)",1992,2018,26,"27",13674
"POINT(-68.871657 43.27657)",1985,2016,31,"32",14631
"POINT(-61.56738 44.19795)",1999,2014,15,"9",12174
"POINT(-70.87637 46.85767)",2016,2021,5,"6",16122
"POINT(-59.12841 47.47266)",1974,2010,36,"37",14580
"POINT(-63.2 42)",1973,1986,13,"14",13181
"POINT(-65.090012 44.451082)",1996,1997,1,"2",14092
"POINT(-63.427139 46.193528)",2011,2014,3,"2",15301
"POINT(-68.3 43.3)",2007,2014,7,"8",14554
"POINT(-78.523333 45.595278)",1952,1995,43,"43",12961
"POINT(-63.66575 45.8547)",2011,2014,3,"2",15543
"POINT(-62.74132 45.67583)",2005,2008,3,"4",15454
"POINT(-61.56738 44.19795)",1982,1994,12,"13",11457
"POINT(-65.098835 42.729563)",1973,1994,21,"19",10432
"POINT(-74.018383 39.10066)",1971,2016,45,"46",14732
"POINT(-65.50048 43.2532)",1995,2016,21,"22",12095
"POINT(-60.3 44.1)",1967,1990,23,"24",13375
"POINT(-72.88129 46.69751)",2016,2021,5,"6",16228
"POINT(-65.63232 43.2452)",1970,2010,40,"41",14211
"POINT(-57 46.06667)",1993,2013,20,"20",11212
"POINT(-65.50048 43.2532)",1995,2016,21,"22",11678
"POINT(-65.50048 43.2532)",1986,1988,2,"2",12251
"POINT(-63.802767 46.136433)",2005,2008,3,"3",15549
"POINT(-74.381869 45.160229)",1984,2018,34,"17",13637
"POINT(-52.782383 44.683779)",1970,1994,24,"16",10991
"POINT(-52.757812 52.054271)",1977,1994,17,"18",14864
"POINT(-65.50048 43.2532)",1970,1981,11,"10",12009
"POINT(-65.50048 43.2532)",1970,1981,11,"12",11822
"POINT(-61 45)",1999,2006,7,"8",13021
"POINT(-52.782383 44.683779)",1970,1994,24,"19",10240
"POINT(-82.517801 41.970728)",2002,2003,1,"2",15022
"POINT(-86 50)",1970,2014,44,"45",12835
"POINT(-79.361398 43.62142)",2006,2012,6,"4",13555
"POINT(-82.134735 48.575324)",2002,2004,2,"3",10098
"POINT(-71.71751 46.41901)",2017,2021,4,"4",16017
"POINT(-62.90725 46.058533)",2005,2010,5,"5",15213
"POINT(-80.116667 45.133333)",1991,1994,3,"4",12734
"POINT(-78.523333 45.595278)",1952,1995,43,"43",12947
"POINT(-56.766309 56.477534)",1978,1991,13,"8",10563
"POINT(-72.47958 46.88236)",2016,2021,5,"2",15961
"POINT(-52.150931 52.188158)",1978,1994,16,"17",13126
"POINT(-68.615921 41.275324)",1963,2016,53,"54",14484
"POINT(-65.63232 43.2452)",1970,2002,32,"33",14335
"POINT(-62.74132 45.67583)",2011,2014,3,"2",15361
"POINT(-65.50048 43.2532)",1995,2016,21,"22",12479
"POINT(-56.383301 46.711721)",1984,1993,9,"5",14868
"POINT(-48.319336 48.138699)",1984,1995,11,"12",14926
"POINT(-59.348941 46.441917)",1985,1994,9,"6",10490
"POINT(-57.690888 43.437611)",1970,1994,24,"16",11052
"POINT(-62.067902 49.652037)",1985,1994,9,"10",11099
"POINT(-64.554866 46.218937)",2008,2009,1,"2",15717
"POINT(-56.383301 46.711721)",1972,1982,10,"10",14921
"POINT(-65.50048 43.2532)",1971,1979,8,"3",12646
"POINT(-49.931212 51.171824)",1983,2011,28,"29",14384
"POINT(-65.50048 43.2532)",1970,1981,11,"12",12324
"POINT(-55.3 46)",1959,1993,34,"35",13285
"POINT(-73.107078 52.941847)",1970,2014,44,"45",12819
"POINT(-65.50048 43.2532)",1970,1981,11,"12",12597
"POINT(-58.452138 49.69674)",1971,1994,23,"22",10237
"POINT(-65.62222 47.65259)",2009,2010,1,"2",15422
"POINT(-59.853639 59.286076)",1978,1991,13,"6",10964
"POINT(-61.56738 44.19795)",1996,2008,12,"9",11599
"POINT(-58.635512 47.364248)",1972,1994,22,"21",10873
"POINT(-63.728047 47.637685)",1977,1994,17,"9",10333
"POINT(-56 52)",1971,2010,39,"40",11218
"POINT(-53.864595 53.910492)",1977,1982,5,"3",10925
"POINT(-56.33304 48.60645)",1980,2016,36,"37",12745
"POINT(-72.957967 46.778085)",2000,2001,1,"2",15835
"POINT(-65.098835 42.729563)",1970,1994,24,"25",10531
"POINT(-50.75978 47.607599)",1970,1994,24,"25",10189
"POINT(-66.214847 41.627502)",1980,1993,13,"11",10988
"POINT(-72.47958 46.88236)",2016,2021,5,"2",15906
"POINT(-61.56738 44.19795)",1995,2016,21,"22",12439
"POINT(-61.56738 44.19795)",1995,2016,21,"22",12501
"POINT(-63.728047 47.637685)",1985,1990,5,"3",10855
"POINT(-70.87637 46.85767)",2016,2018,2,"3",16191
"POINT(-77.72313 43.99472)",2008,2015,7,"2",13797
"POINT(-61.56738 44.19795)",1970,1981,11,"12",12582
"POINT(-59 44.1)",1976,1990,14,"15",13237
"POINT(-69.666667 48.15)",1994,2004,10,"11",12917
"POINT(-72 54)",1970,2014,44,"45",12827
"POINT(-50.521046 49.772834)",1975,2006,31,"32",14618
"POINT(-65.090012 44.451082)",1996,1997,1,"2",14068
"POINT(-71.71751 46.41901)",2016,2021,5,"5",15951
"POINT(-65.63232 43.2452)",1970,2010,40,"41",14261
"POINT(-63.728047 47.637685)",1970,1994,24,"25",10773
"POINT(-58.452138 49.69674)",1977,1994,17,"6",10740
"POINT(-61.36333 41.90833)",1970,2000,30,"31",11196
"POINT(-73.19306 45.5675)",1966,1976,10,"10",12977
"POINT(-58.02978 50.13466)",1973,2003,30,"31",14367
"POINT(-51 49.15)",1980,1996,16,"17",13367
"POINT(-63 45)",1991,2000,9,"6",9998
"POINT(-61.56738 44.19795)",1970,1981,11,"12",12236
"POINT(-63.758716 46.383956)",2007,2010,3,"4",15512
"POINT(-61.181309 42.866877)",1970,1994,24,"25",10743
"POINT(-52.782383 44.683779)",1970,1994,24,"24",10514
"POINT(-65.50048 43.2532)",1995,2016,21,"22",12136
"POINT(-62.547863 46.172776)",2005,2010,5,"5",15098
"POINT(-65.098835 42.729563)",1970,1994,24,"25",10152
"POINT(-61.56738 44.19795)",1982,1994,12,"13",12216
"POINT(-58.635512 47.364248)",1971,1994,23,"22",10513
"POINT(-77.229936 44.152886)",1992,2018,26,"27",13762
"POINT(-59.853639 59.286076)",1978,1991,13,"4",10641
"POINT(-63.165833 46.420833)",2011,2014,3,"2",15195
"POINT(-64.8083 47.67109)",2009,2010,1,"2",15638
"POINT(-59.348941 46.441917)",1970,1993,23,"24",10587
"POINT(-61.56738 44.19795)",1973,1980,7,"4",12254
"POINT(-48.319336 48.138699)",1984,1995,11,"12",14950
"POINT(-56 49)",1990,2010,20,"21",11215
"POINT(-61.56738 44.19795)",1970,1981,11,"10",11367
"POINT(-58.452138 49.69674)",1981,1994,13,"7",10816
"POINT(-76.794435 44.062208)",1992,2018,26,"27",13619
"POINT(-70.87637 46.85767)",2016,2021,5,"6",16103
"POINT(-59.853639 59.286076)",1978,1988,10,"4",10231
"POINT(-65.50048 43.2532)",1995,2016,21,"8",11559
"POINT(-48.319336 48.138699)",1985,1995,10,"11",14855
"POINT(-63.446958 46.46855)",2011,2014,3,"2",15234
"POINT(-64.646046 47.789535)",2011,2014,3,"2",15298
"POINT(-65.50048 43.2532)",1995,2016,21,"22",12362
"POINT(-63.739472 45.85055)",2008,2009,1,"2",15563
"POINT(-67.064717 44.266029)",1971,1993,22,"20",10583
"POINT(-69.666667 48.15)",1994,2005,11,"12",12908
"POINT(-82.89183 35.26499)",1974,1981,7,"8",12987
"POINT(-64.8083 47.67109)",2009,2010,1,"2",15769
"POINT(-65.50048 43.2532)",1995,2016,21,"21",11619
"POINT(-72.82857 45.04889)",2016,2019,3,"2",16210
"POINT(-74.018383 39.10066)",1975,2005,30,"31",14320
"POINT(-62.74132 45.67583)",2004,2010,6,"7",15587
"POINT(-61.56738 44.19795)",1995,2016,21,"22",11375
"POINT(-86 50)",1970,2014,44,"45",12656
"POINT(-63 47)",1971,2016,45,"44",10034
"POINT(-59 49.25)",1965,2017,52,"53",14779
"POINT(-59.348941 46.441917)",1970,1990,20,"10",10796
"POINT(-61.56738 44.19795)",1982,1994,12,"13",11804
"POINT(-62.735984 45.290147)",1970,2014,44,"45",12710
"POINT(-72 40)",1973,2016,43,"44",14445
"POINT(-61.56738 44.19795)",1995,2016,21,"22",12514
"POINT(-56 52)",1974,2014,40,"41",12833
"POINT(-69.041914 40.95268)",1969,2008,39,"40",14616
"POINT(-73.107078 52.941847)",1970,2014,44,"45",12719
"POINT(-62.74132 45.67583)",2004,2010,6,"5",15138
"POINT(-64.56477 46.273319)",2007,2010,3,"4",15399
"POINT(-50 43.083333)",2002,2011,9,"10",13444
"POINT(-60.79843 53.003392)",1974,2014,40,"41",12816
"POINT(-64.554866 46.218937)",2011,2014,3,"2",15243
"POINT(-62.04944 46.02944)",1971,1995,24,"25",11190
"POINT(-63 47)",1978,2009,31,"32",11234
"POINT(-62.547863 46.172776)",2005,2010,5,"4",15652
"POINT(-59 49.25)",1965,2017,52,"53",14472
"POINT(-79.37806 44.73333)",1980,1987,7,"8",13360
"POINT(-70.87637 46.85767)",2016,2021,5,"5",16034
"POINT(-51.3 44.3)",1968,1986,18,"19",13151
"POINT(-65.029957 47.777114)",2004,2010,6,"7",15535
"POINT(-61.56738 44.19795)",1995,2016,21,"22",11616
"POINT(-86 50)",1970,2014,44,"45",12763
"POINT(-59.348941 46.441917)",1970,1994,24,"7",10554
"POINT(-66.11572 44.8247)",1997,2012,15,"16",14549
"POINT(-61.56738 44.19795)",1995,2016,21,"20",11507
"POINT(-59 49.25)",1965,2017,52,"53",14723
"POINT(-59.853639 59.286076)",1978,1991,13,"4",10824
"POINT(-74.018383 39.10066)",1967,2005,38,"39",14344
"POINT(-61.56738 44.19795)",1995,2016,21,"22",12303
"POINT(-71.71751 46.41901)",2018,2020,2,"2",16175
"POINT(-78.523333 45.595278)",1972,1991,19,"19",11275
"POINT(-65.57426 46.98624)",2011,2014,3,"2",15188
"POINT(-77.59299 44.01301)",2001,2015,14,"3",13791
"POINT(-64.965766 47.341712)",2011,2014,3,"2",15350
"POINT(-60.79843 53.003392)",1980,2014,34,"35",12871
"POINT(-55.995809 46.034584)",1974,1994,20,"12",10786
"POINT(-61.56738 44.19795)",1982,1993,11,"12",11893
"POINT(-78.523333 45.595278)",1952,1995,43,"43",12956
"POINT(-72 54)",1970,2014,44,"45",12784
"POINT(-64.657552 47.746584)",2004,2010,6,"7",15075
"POINT(-72.47958 46.88236)",2016,2021,5,"2",16142
"POINT(-61.1985 45.9668)",1996,1997,1,"2",14088
"POINT(-65.50048 43.2532)",1970,1981,11,"11",11610
"POINT(-60.3 44.1)",1967,1990,23,"24",13249
"POINT(-52.121122 50.695322)",1973,1994,21,"15",10425
"POINT(-79.361398 43.62142)",2006,2012,6,"4",13569
"POINT(-77.229936 44.152886)",1992,2018,26,"27",13644
"POINT(-52.782383 44.683779)",1975,1994,19,"14",10351
"POINT(-79.146454 46.634905)",2002,2004,2,"3",10113
"POINT(-82.5 42.166667)",1990,2010,20,"21",13000
"POINT(-55.3 46)",1959,1993,34,"35",13411
"POINT(-61.181309 42.866877)",1970,1994,24,"25",10532
"POINT(-65.562778 46.995278)",2011,2014,3,"2",15443
"POINT(-53.864595 53.910492)",1970,1994,24,"23",10466
"POINT(-61.56738 44.19795)",1970,1981,11,"12",12298
"POINT(-65.098835 42.729563)",1970,1994,24,"25",10157
"POINT(-79.85068 43.28331)",2006,2015,9,"6",13862
"POINT(-65.50048 43.2532)",1982,1994,12,"13",12213
"POINT(-71.71751 46.41901)",2016,2021,5,"5",16205
"POINT(-72.82857 45.04889)",2016,2021,5,"3",16044
"POINT(-68.526458 40.575228)",1982,2016,34,"35",14787
"POINT(-72.47958 46.88236)",2016,2021,5,"2",16218
"POINT(-72.88129 46.69751)",2016,2020,4,"4",16027
"POINT(-58.452138 49.69674)",1970,1994,24,"24",10748
"POINT(-63.446958 46.46855)",2004,2010,6,"7",15068
"POINT(-63 47)",1971,2016,45,"46",10058
"POINT(-61.56738 44.19795)",2011,2015,4,"2",12577
"POINT(-66.486934 47.136578)",2001,2002,1,"2",15861
"POINT(-55.995809 46.034584)",1970,1994,24,"24",10834
"POINT(-58.635512 47.364248)",1973,1994,21,"10",10440
"POINT(-58.02978 50.13466)",1973,2003,30,"31",14192
"POINT(-50.3 44.3)",1965,1986,21,"22",13305
"POINT(-64.861867 46.665292)",2006,2010,4,"5",15636
"POINT(-64.951922 46.75123)",2009,2010,1,"2",15702
"POINT(-62.735984 45.290147)",1970,2014,44,"45",12873
"POINT(-84.499722 49.25)",1995,2006,11,"12",9993
"POINT(-66.214847 41.627502)",1980,1993,13,"10",10246
"POINT(-59.348941 46.441917)",1974,1994,20,"16",10604
"POINT(-65.50048 43.2532)",1995,2016,21,"22",11794
"POINT(-59 50)",1985,2003,18,"19",11226
"POINT(-61.56738 44.19795)",1995,2016,21,"20",11774
"POINT(-62.44628 43.89789)",1974,2008,34,"35",14313
"POINT(-79.37806 44.73333)",1980,1987,7,"8",13171
"POINT(-82.5 42.166667)",1972,2002,30,"2",10130
"POINT(-48.319336 48.138699)",1975,1982,7,"8",14881
"POINT(-50.521046 49.772834)",1975,2006,31,"32",14674
"POINT(-76.794435 44.062208)",1992,2018,26,"27",14027
"POINT(-61.56738 44.19795)",1995,2016,21,"22",12116
"POINT(-66.214847 41.627502)",1981,1993,12,"8",10768
"POINT(-61.56738 44.19795)",1995,2016,21,"22",12193
"POINT(-53.864595 53.910492)",1976,1990,14,"10",10784
"POINT(-63.06152 46.75491)",1970,2011,41,"42",14282
"POINT(-64.861867 46.665292)",2011,2014,3,"2",15613
"POINT(-72.88129 46.69751)",2016,2021,5,"6",15922
"POINT(-59.12841 47.47266)",1974,2010,36,"37",14468
"POINT(-65.25 44.333333)",1996,1997,1,"2",14091
"POINT(-61.164851 45.857738)",1996,1997,1,"2",14079
"POINT(-74.381869 45.160229)",1984,2018,34,"17",13641
"POINT(-61.56738 44.19795)",1998,2009,11,"3",12108
"POINT(-56.33304 48.60645)",1980,2016,36,"37",12736
"POINT(-66.089296 44.42804)",1999,2006,7,"8",11140
"POINT(-63.06152 46.75491)",1978,2018,40,"41",14634
"POINT(-53.864595 53.910492)",1985,1992,7,"5",10336
"POINT(-63.728047 47.637685)",1972,1994,22,"21",10677
"POINT(-63 47)",1978,1990,12,"13",13372
"POINT(-61.455567 46.07815)",2008,2010,2,"3",15485
"POINT(-65.098835 42.729563)",1970,1994,24,"25",10843
"POINT(-77.072526 44.096244)",1992,2018,26,"27",13585
"POINT(-63.394728 46.363106)",2001,2002,1,"2",15852
"POINT(-63.902612 46.237205)",2001,2003,2,"3",10071
"POINT(-61.87121 45.68314)",2011,2014,3,"2",15624
"POINT(-61.56738 44.19795)",1995,2016,21,"18",11921
"POINT(-73.107078 52.941847)",1970,2014,44,"45",12711
"POINT(-76.794435 44.062208)",1992,2018,26,"27",13678
"POINT(-65.50048 43.2532)",1995,2016,21,"17",11370
"POINT(-58.452138 49.69674)",1970,1994,24,"22",10911
"POINT(-77.80861 43.698439)",1997,2012,15,"15",13514
"POINT(-61.56738 44.19795)",1997,2016,19,"13",11594
"POINT(-65.50048 43.2532)",1982,1994,12,"13",11670
"POINT(-55.69917 47.88361)",1987,2010,23,"24",11217
"POINT(-84.52551 50.219196)",2016,2017,1,"2",14996
"POINT(-57.05 51)",1971,1995,24,"25",13169
"POINT(-67 41)",1950,1998,48,"49",13133
"POINT(-61.56738 44.19795)",1982,1994,12,"13",11997
"POINT(-65.3 43)",1962,1988,26,"27",13156
"POINT(-62.067902 49.652037)",1988,1994,6,"6",10520
"POINT(-77.229936 44.152886)",1992,2018,26,"27",13714
"POINT(-78.291582 43.944964)",1974,1985,11,"9",13485
"POINT(-52.757812 52.054271)",1977,1994,17,"18",14958
"POINT(-61.181309 42.866877)",1978,1994,16,"10",11066
"POINT(-56.766309 56.477534)",1977,1991,14,"10",10244
"POINT(-65.50048 43.2532)",1995,2016,21,"21",12153
"POINT(-59.348941 46.441917)",1970,1994,24,"25",10878
"POINT(-79.361398 43.62142)",2006,2012,6,"4",13495
"POINT(-63.758716 46.383956)",2011,2014,3,"2",15282
"POINT(-62.90725 46.058533)",2005,2009,4,"2",15718
"POINT(-62.74132 45.67583)",2004,2010,6,"7",15688
"POINT(-78.523333 45.595278)",1952,1995,43,"43",12946
"POINT(-57.690888 43.437611)",1970,1994,24,"25",10533
"POINT(-61.56738 44.19795)",1982,1994,12,"13",11814
"POINT(-58.635512 47.364248)",1973,1993,20,"11",10362
"POINT(-82.517801 41.970728)",2002,2003,1,"2",15020
"POINT(-79.26667 40.16667)",1979,1999,20,"21",13084
"POINT(-53.864595 53.910492)",1970,1994,24,"24",10153
"POINT(-65.50048 43.2532)",1970,1981,11,"12",11413
"POINT(-58.93 43.84)",1988,2011,23,"18",15849
"POINT(-53.864595 53.910492)",1970,1994,24,"24",10185
"POINT(-61.56738 44.19795)",1970,1981,11,"12",11532
"POINT(-61.56738 44.19795)",1995,2016,21,"22",11572
"POINT(-79.361398 43.62142)",2006,2012,6,"4",13499
"POINT(-59.853639 59.286076)",1978,1991,13,"6",10216
"POINT(-77.80861 43.698439)",1997,2012,15,"15",13460
"POINT(-60.79843 53.003392)",1974,2014,40,"41",12882
"POINT(-58.635512 47.364248)",1986,1994,8,"7",10818
"POINT(-55.995809 46.034584)",1970,1994,24,"24",10574
"POINT(-68.615921 41.275324)",1963,2005,42,"43",14322
"POINT(-62.547863 46.172776)",2011,2014,3,"2",15263
"POINT(-64.861867 46.665292)",2006,2010,4,"5",15767
"POINT(-65.50048 43.2532)",1970,1978,8,"6",12181
"POINT(-67.86528 44.36722)",1968,1998,30,"26",9943
"POINT(-74.381869 45.160229)",2006,2018,12,"7",13915
"POINT(-78.5 45.58333)",1976,1989,13,"14",10125
"POINT(-64.951922 46.75123)",2011,2014,3,"2",15181
"POINT(-55.81867 47.371089)",1982,2009,27,"28",11255
"POINT(-72.47958 46.88236)",2016,2021,5,"2",16174
"POINT(-64.351142 48.893948)",1982,2009,27,"4",14824
"POINT(-81.87611 45.625)",1950,1983,33,"34",13359
"POINT(-64.965766 47.341712)",2004,2010,6,"7",15315
"POINT(-72.82857 45.04889)",2016,2019,3,"2",15878
"POINT(-74.018383 39.10066)",1982,2015,33,"34",14761
"POINT(-82.81667 42.16667)",1992,1994,2,"3",13012
"POINT(-61.181309 42.866877)",1974,1988,14,"4",10631
"POINT(-52.757812 52.054271)",1977,1994,17,"18",14910
"POINT(-77.229936 44.152886)",1992,2018,26,"27",13663
"POINT(-61.87121 45.68314)",2008,2009,1,"2",15425
"POINT(-49.931212 51.171824)",1983,2011,28,"29",14359
"POINT(-63.902612 46.237205)",2001,2003,2,"3",10088
"POINT(-77.22225 44.149251)",2001,2015,14,"14",13591
"POINT(-60.782507 46.459772)",2001,2015,14,"6",11135
"POINT(-58.452138 49.69674)",1979,1994,15,"9",10525
"POINT(-62.067902 49.652037)",1972,1994,22,"22",10510
"POINT(-84.499722 49.25)",1995,2006,11,"12",9956
"POINT(-72.88129 46.69751)",2019,2020,1,"2",16148
"POINT(-52.121122 50.695322)",1970,1994,24,"17",10395
"POINT(-72.47958 46.88236)",2016,2021,5,"2",15957
"POINT(-68.615921 41.275324)",1970,2016,46,"47",14514
"POINT(-71.093778 40.671798)",1968,2006,38,"39",14177
"POINT(-61.56738 44.19795)",1982,1994,12,"13",12407
"POINT(-59 44)",1988,1998,10,"9",13016
"POINT(-61.56738 44.19795)",1970,1981,11,"12",11683
"POINT(-65.090012 44.451082)",1996,1997,1,"2",14086
"POINT(-55.995809 46.034584)",1970,1994,24,"24",10538
"POINT(-61.56738 44.19795)",1970,1981,11,"7",12546
"POINT(-52.782383 44.683779)",1980,1994,14,"5",10363
"POINT(-64.11454 46.1827)",2009,2010,1,"2",15573
"POINT(-53.864595 53.910492)",1971,1994,23,"21",10722
"POINT(-65.50048 43.2532)",1982,1994,12,"13",12256
"POINT(-72.47958 46.88236)",2016,2021,5,"2",16159
"POINT(-56.383301 46.711721)",1972,1982,10,"11",14872
"POINT(-82.517801 41.970728)",2002,2003,1,"2",15037
"POINT(-61.25 45.75)",1996,1997,1,"2",14058
"POINT(-62.11238 46.383134)",2011,2014,3,"2",15266
"POINT(-63.427139 46.193528)",2011,2014,3,"2",15678
"POINT(-77.229936 44.152886)",1992,2018,26,"27",13656
"POINT(-65.50048 43.2532)",1970,1981,11,"12",12500
"POINT(-86 50)",1970,2014,44,"45",12673
"POINT(-76.06 44.055)",1976,2015,39,"29",13046
"POINT(-72.88129 46.69751)",2016,2021,5,"6",15982
"POINT(-68.615921 41.275324)",1950,2007,57,"58",14599
"POINT(-65.50048 43.2532)",1970,1980,10,"8",11812
"POINT(-86 50)",1970,2014,44,"45",12658
"POINT(-62.067902 49.652037)",1973,1994,21,"13",10348
"POINT(-63.728047 47.637685)",1977,1993,16,"5",10196
"POINT(-59.12841 47.47266)",1974,2010,36,"37",14776
"POINT(-64.861867 46.665292)",2011,2014,3,"2",15288
"POINT(-63.728047 47.637685)",1972,1994,22,"21",11054
"POINT(-72.82857 45.04889)",2016,2021,5,"2",15949
"POINT(-81.87611 45.625)",1950,1983,33,"34",13422
"POINT(-86 50)",1970,2014,44,"45",12685
"POINT(-79.85068 43.28331)",2006,2015,9,"6",13796
"POINT(-62.511072 46.018891)",2005,2010,5,"3",15795
"POINT(-65.50048 43.2532)",1996,2012,16,"8",11970
"POINT(-75.348421 39.407679)",1961,2013,52,"53",11131
"POINT(-68.615921 41.275324)",1970,2016,46,"47",14486
"POINT(-78.291582 43.944964)",1987,2016,29,"30",13982
"POINT(-71.71751 46.41901)",2017,2021,4,"3",16078
"POINT(-64.126831 46.773778)",2004,2010,6,"7",15116
"POINT(-65.50048 43.2532)",1982,1994,12,"13",12393
"POINT(-74.58861 36.44722)",1985,2014,29,"30",14464
"POINT(-65.57426 46.98624)",2008,2010,2,"3",15569
"POINT(-48.319336 48.138699)",1975,1982,7,"8",14954
"POINT(-66.214847 41.627502)",1980,1993,13,"11",10529
"POINT(-61.56738 44.19795)",1970,1980,10,"6",11382
"POINT(-74.381869 45.160229)",1984,2018,34,"16",13636
"POINT(-67.064717 44.266029)",1972,1994,22,"20",10989
"POINT(-65.098835 42.729563)",1970,1994,24,"25",10505
"POINT(-81.87611 45.625)",1950,1983,33,"34",13212
"POINT(-63 47)",1978,1990,12,"13",13183
"POINT(-75.23807 45.200085)",1995,2004,9,"10",10096
"POINT(-58.635512 47.364248)",1971,1994,23,"22",11077
"POINT(-65.098835 42.729563)",1970,1994,24,"24",11094
"POINT(-61.25 45.75)",1996,1997,1,"2",14082
"POINT(-65.50048 43.2532)",1982,1994,12,"13",12143
"POINT(-77.072526 44.096244)",1992,2018,26,"27",13729
"POINT(-61.87121 45.68314)",2004,2009,5,"3",15709
"POINT(-61.56738 44.19795)",1995,2016,21,"22",12510
"POINT(-71.71751 46.41901)",2018,2021,3,"3",16104
"POINT(-67.064717 44.266029)",1981,1994,13,"6",10218
"POINT(-65.50048 43.2532)",1970,1981,11,"6",12318
"POINT(-61.56738 44.19795)",1995,2016,21,"15",12113
"POINT(-71.772245 43.931185)",2012,2018,6,"5",13086
"POINT(-69.041914 40.95268)",1984,2016,32,"33",14587
"POINT(-65.50048 43.2532)",1982,1994,12,"13",12415
"POINT(-65.50048 43.2532)",1972,1981,9,"9",12569
"POINT(-64.861867 46.665292)",2011,2014,3,"2",15275
"POINT(-65.50048 43.2532)",1970,1981,11,"12",12013
"POINT(-66.214847 41.627502)",1981,1993,12,"9",10841
"POINT(-61.56738 44.19795)",1977,1981,4,"4",11394
"POINT(-66.214847 41.627502)",1977,1993,16,"12",10174
"POINT(-51.3 44.3)",1968,1986,18,"19",13361
"POINT(-63.802767 46.136433)",2005,2010,5,"6",15601
"POINT(-84.499722 49.25)",1995,2005,10,"11",9968
"POINT(-63.427139 46.193528)",2008,2010,2,"3",15570
"POINT(-77.547686 43.947746)",1992,2018,26,"27",13686
"POINT(-72.82857 45.04889)",2019,2019,0,"2",16096
"POINT(-63.758716 46.383956)",2007,2010,3,"4",15395
"POINT(-65.50048 43.2532)",1982,1994,12,"8",11657
"POINT(-53.183333 49.75)",2000,2003,3,"3",11185
"POINT(-63.2 42)",1973,1986,13,"14",13413
"POINT(-79.37806 44.73333)",1980,1987,7,"8",13402
"POINT(-56.766309 56.477534)",1978,1991,13,"3",10629
"POINT(-63.2 42)",1973,1986,13,"14",13308
"POINT(-77.547686 43.947746)",1992,2012,20,"21",13456
"POINT(-65.50048 43.2532)",1996,2016,20,"12",12110
"POINT(-61.56738 44.19795)",1971,1974,3,"2",11498
"POINT(-53.766667 49.583333)",1973,2001,28,"4",14812
"POINT(-63.728047 47.637685)",1970,1994,24,"25",10228
"POINT(-47.89333 50.44083)",1983,2018,35,"36",14240
"POINT(-63.728047 47.637685)",1970,1994,24,"25",10980
"POINT(-63.06152 46.75491)",1978,2018,40,"41",14523
"POINT(-61.56738 44.19795)",1983,1993,10,"8",11655
"POINT(-76.698994 45.649011)",1997,2000,3,"2",12995
"POINT(-71.093778 40.671798)",1967,2005,38,"39",14125
"POINT(-61.56738 44.19795)",1970,1981,11,"12",12006
"POINT(-77.547686 43.947746)",1992,2018,26,"27",13923
"POINT(-59.822611 42.550438)",1983,2008,25,"16",11252
"POINT(-65.50048 43.2532)",1970,1981,11,"12",12223
"POINT(-79.361398 43.62142)",2006,2012,6,"4",13468
"POINT(-47.89333 50.44083)",1983,2018,35,"36",14290
"POINT(-68.871657 43.27657)",1985,2016,31,"32",14799
"POINT(-60.3 44.1)",1967,1990,23,"24",13270
"POINT(-85.58269 49.249515)",1981,1984,3,"4",15817
"POINT(-76.56667 44.3)",1982,1997,15,"16",15838
"POINT(-77.396972 43.506083)",1997,2018,21,"9",14030
"POINT(-74 41.16667)",1980,2000,20,"21",13018
"POINT(-61.87121 45.68314)",2011,2014,3,"2",15278
"POINT(-71.71751 46.41901)",2016,2019,3,"4",15990
"POINT(-48.319336 48.138699)",1985,1995,10,"11",14951
"POINT(-78.523333 45.595278)",1952,1995,43,"43",12955
"POINT(-61.455567 46.07815)",2011,2014,3,"2",15743
"POINT(-60.3 44.1)",1967,1990,23,"24",13143
"POINT(-65.029957 47.777114)",2011,2014,3,"2",15147
"POINT(-56.383301 46.711721)",1972,1978,6,"7",14895
"POINT(-61.56738 44.19795)",1995,2016,21,"21",11704
"POINT(-77.072526 44.096244)",1992,2018,26,"27",13672
"POINT(-61.25 45.75)",1996,1997,1,"2",14074
"POINT(-61.56738 44.19795)",1995,2016,21,"22",12268
"POINT(-48.33984 44.59046)",1977,2000,23,"24",14162
"POINT(-66.890519 50.02395)",1990,1997,7,"8",13066
"POINT(-63.728047 47.637685)",1984,1994,10,"6",10644
"POINT(-53.864595 53.910492)",1978,1992,14,"4",10812
"POINT(-64.657552 47.746584)",2006,2007,1,"2",15583
"POINT(-65.50048 43.2532)",1982,1994,12,"13",11355
"POINT(-66.46191 46.56531)",2013,2015,2,"3",12935
"POINT(-67.5 40.4)",1955,1987,32,"33",13194
"POINT(-65.50048 43.2532)",1982,1994,12,"13",12554
"POINT(-64.209251 44.537006)",1985,2012,27,"19",11304
"POINT(-72.82857 45.04889)",2016,2021,5,"3",16192
"POINT(-79.85068 43.28331)",2006,2014,8,"6",13785
"POINT(-74.381869 45.160229)",1984,2018,34,"16",13752
"POINT(-61.87121 45.68314)",2005,2010,5,"4",15433
"POINT(-64.861867 46.665292)",2011,2014,3,"2",15776
"POINT(-60.3 44.1)",1967,1990,23,"24",13269
"POINT(-65.029957 47.777114)",2011,2014,3,"2",15152
"POINT(-65.50048 43.2532)",1970,1981,11,"12",11956
"POINT(-61.56738 44.19795)",1970,1981,11,"12",11464
"POINT(-61.181309 42.866877)",1978,1989,11,"7",10938
"POINT(-61.87121 45.68314)",2004,2010,6,"7",15805
"POINT(-68.526458 40.575228)",1964,2016,52,"53",14518
"POINT(-64.657552 47.746584)",2004,2010,6,"7",15206
"POINT(-61.56738 44.19795)",1970,1981,11,"12",11340
"POINT(-72.88129 46.69751)",2016,2021,5,"6",16214
"POINT(-68.615921 41.275324)",1963,2005,42,"43",14247
"POINT(-56 52)",1974,2014,40,"41",12666
"POINT(-64.861867 46.665292)",2006,2010,4,"5",15210
"POINT(-63 45)",1970,2014,44,"45",12850
"POINT(-61.87121 45.68314)",2011,2014,3,"2",15158
"POINT(-71.71751 46.41901)",2016,2021,5,"5",16179
"POINT(-65.50048 43.2532)",1995,2016,21,"22",12472
"POINT(-59 49.25)",1965,2017,52,"53",14667
"POINT(-72.82857 45.04889)",2016,2021,5,"2",16138
"POINT(-52.121122 50.695322)",1981,1994,13,"7",11005
"POINT(-58.635512 47.364248)",1971,1994,23,"14",10969
"POINT(-53.864595 53.910492)",1971,1994,23,"15",11037
"POINT(-65.090012 44.451082)",1996,1997,1,"2",14094
"POINT(-63.06152 46.75491)",1970,2011,41,"42",14232
"POINT(-57.690888 43.437611)",1983,1992,9,"3",10643
"POINT(-63.2 42)",1973,1986,13,"14",13307
"POINT(-79.37806 44.73333)",1980,1987,7,"8",13213
"POINT(-63.728047 47.637685)",1981,1994,13,"11",10555
"POINT(-77.229936 44.152886)",1992,2018,26,"27",13704
"POINT(-77.229936 44.152886)",1992,2018,26,"27",13646
"POINT(-65.50048 43.2532)",1995,2016,21,"16",11684
"POINT(-61.181309 42.866877)",1970,1994,24,"25",10148
"POINT(-56.383301 46.711721)",1972,1978,6,"7",14919
"POINT(-68.615921 41.275324)",1963,2009,46,"47",14541
"POINT(-68.615921 41.275324)",1963,2009,46,"47",14793
"POINT(-61.455567 46.07815)",2004,2009,5,"4",15140
"POINT(-66.214847 41.627502)",1980,1993,13,"7",10302
"POINT(-56.766309 56.477534)",1978,1988,10,"4",10903
"POINT(-52.782383 44.683779)",1979,1993,14,"3",10985
"POINT(-61.181309 42.866877)",1982,1986,4,"3",10367
"POINT(-60 43.91667)",1991,1998,7,"8",10095
"POINT(-60.3 44.1)",1967,1990,23,"24",13164
"POINT(-64.646046 47.789535)",2004,2010,6,"7",15529
"POINT(-84.499722 49.25)",1995,2004,9,"9",9983
"POINT(-75.688981 36.091782)",1988,2006,18,"13",13035
"POINT(-70.87637 46.85767)",2017,2021,4,"5",15886
"POINT(-57.41455 46.93526)",1983,2011,28,"28",14308
"POINT(-59.853639 59.286076)",1979,1991,12,"3",10627
"POINT(-65.50048 43.2532)",1982,1994,12,"13",12489
"POINT(-59.348941 46.441917)",1974,1994,20,"19",10676
"POINT(-77.22225 44.149251)",2001,2015,14,"14",13885
"POINT(-61.56738 44.19795)",1998,2006,8,"3",12512
"POINT(-49.931212 51.171824)",1983,2011,28,"29",14134
"POINT(-72.82857 45.04889)",2016,2021,5,"3",16100
"POINT(-63.888896 46.512101)",2011,2014,3,"2",15252
"POINT(-64.209251 44.537006)",1985,2012,27,"19",11292
"POINT(-64.11454 46.1827)",2011,2014,3,"2",15192
"POINT(-48.319336 48.138699)",1984,1995,11,"12",14925
"POINT(-58.81667 48.13333)",1980,1996,16,"7",12974
"POINT(-84.33688 45.425484)",2001,2010,9,"10",12733
"POINT(-65.50048 43.2532)",1982,1994,12,"12",12034
"POINT(-65.50048 43.2532)",1970,1981,11,"12",11754
"POINT(-72.82857 45.04889)",2016,2021,5,"3",16114
"POINT(-79.361398 43.62142)",2006,2012,6,"4",13558
"POINT(-58.635512 47.364248)",1971,1994,23,"22",10777
"POINT(-68.526458 40.575228)",1982,2016,34,"35",14731
"POINT(-65.50048 43.2532)",1982,1993,11,"4",12371
"POINT(-76.794435 44.062208)",1992,2018,26,"27",13738
"POINT(-61.56738 44.19795)",1970,1981,11,"12",11558
"POINT(-65.63232 43.2452)",1970,2002,32,"33",14285
"POINT(-63 47)",1978,1990,12,"13",13352
"POINT(-62.916667 47.416667)",1971,2012,41,"42",15041
"POINT(-62.44628 43.89789)",1974,2008,34,"35",14138
"POINT(-71.71751 46.41901)",2016,2021,5,"6",16102
"POINT(-65.50048 43.2532)",1982,1994,12,"13",11932
"POINT(-65.50048 43.2532)",1982,1994,12,"13",11493
"POINT(-64.11454 46.1827)",2009,2010,1,"2",15430
"POINT(-61.56738 44.19795)",1998,2009,11,"3",11841
"POINT(-62.90725 46.058533)",2005,2010,5,"5",15522
"POINT(-69.041914 40.95268)",1984,2016,32,"33",14503
"POINT(-61.56738 44.19795)",1972,1981,9,"2",11644
"POINT(-63.446958 46.46855)",2004,2010,6,"7",15681
"POINT(-62.650653 47.394909)",1952,2012,60,"60",11295
"POINT(-70.87637 46.85767)",2016,2021,5,"6",15931
"POINT(-56.766309 56.477534)",1978,1991,13,"6",10782
"POINT(-65.50048 43.2532)",2011,2013,2,"2",11483
"POINT(-65.50048 43.2532)",1974,1978,4,"2",11571
"POINT(-65.50048 43.2532)",1995,2016,21,"22",11732
"POINT(-63.758716 46.383956)",2007,2009,2,"3",15557
"POINT(-61.56738 44.19795)",1995,2016,21,"22",11488
"POINT(-53.37158 51.46769)",1979,2011,32,"33",14525
"POINT(-61.56738 44.19795)",1970,1980,10,"6",12183
"POINT(-58.452138 49.69674)",1986,1994,8,"3",10521
"POINT(-63.66575 45.8547)",2004,2010,6,"7",15110
"POINT(-56.383301 46.711721)",1972,1982,10,"10",14897
"POINT(-79.146454 46.634905)",2002,2004,2,"3",10105
"POINT(-82.661667 41.703611)",1981,1982,1,"2",13032
"POINT(-77.229936 44.152886)",1992,2018,26,"27",13601
"POINT(-59 49.25)",1965,2017,52,"53",14639
"POINT(-57.66043 53.1355)",1999,2014,15,"16",12740
"POINT(-76.794435 44.062208)",1992,2012,20,"21",13481
"POINT(-77.229936 44.152886)",1992,2012,20,"21",13557
"POINT(-54.93333 49.28333)",1993,2010,17,"18",11216
"POINT(-75.363333 35.224444)",1992,1993,1,"2",12729
"POINT(-57.690888 43.437611)",1970,1990,20,"11",10795
"POINT(-86 50)",1970,2014,44,"45",12865
"POINT(-79.361398 43.62142)",2006,2012,6,"4",13543
"POINT(-61.56738 44.19795)",1983,1994,11,"12",12352
"POINT(-61.56738 44.19795)",1970,1981,11,"8",11317
"POINT(-74.381869 45.160229)",2006,2018,12,"7",13936
"POINT(-57.05 51)",1971,1995,24,"25",13379
"POINT(-61.181309 42.866877)",1982,1986,4,"4",11024
"POINT(-74.381869 45.160229)",1984,2014,30,"6",13917
"POINT(-48.33984 44.59046)",1977,2000,23,"24",14412
"POINT(-61.56738 44.19795)",1970,1981,11,"12",12526
"POINT(-65.50048 43.2532)",1995,2016,21,"22",12522
"POINT(-65.90921 45.50439)",2005,2011,6,"3",15830
"POINT(-56.383301 46.711721)",1972,1978,6,"7",14943
"POINT(-67.064717 44.266029)",1971,1994,23,"19",10530
"POINT(-63.728047 47.637685)",1970,1994,24,"22",10935
"POINT(-61.56738 44.19795)",1995,2016,21,"22",12383
"POINT(-61.56738 44.19795)",1970,1981,11,"12",11757
"POINT(-51 49.15)",1980,1996,16,"17",13409
"POINT(-56.383301 46.711721)",1984,1993,9,"5",14940
"POINT(-72.47958 46.88236)",2016,2021,5,"2",15872
"POINT(-52.940252 44.204538)",1996,2009,13,"13",14840
"POINT(-65.50048 43.2532)",1983,1994,11,"4",11379
"POINT(-71.71751 46.41901)",2018,2021,3,"4",16160
"POINT(-61.455567 46.07815)",2011,2014,3,"2",15462
"POINT(-65.038 45.612)",1986,1991,5,"6",11138
"POINT(-63.802767 46.136433)",2005,2010,5,"6",15537
"POINT(-70.87637 46.85767)",2017,2021,4,"4",16088
"POINT(-71.093778 40.671798)",1989,2016,27,"28",14489
"POINT(-65.50048 43.2532)",1995,2016,21,"22",12205
"POINT(-68.615921 41.275324)",1963,2005,42,"43",14223
"POINT(-61.56738 44.19795)",1983,1993,10,"8",12189
"POINT(-57.690888 43.437611)",1970,1994,24,"25",10507
"POINT(-77.72313 43.99472)",2008,2015,7,"2",13854
"POINT(-82.661667 41.703611)",1981,1982,1,"2",13033
"POINT(-61.56738 44.19795)",1995,2016,21,"22",11530
"POINT(-59 49.25)",1965,2017,52,"53",14444
"POINT(-59.348941 46.441917)",1970,1994,24,"21",10404
"POINT(-77.72313 43.99472)",2008,2015,7,"2",13846
"POINT(-62.44628 43.89789)",1974,2008,34,"35",14263
"POINT(-61.56738 44.19795)",1995,2016,21,"22",11830
"POINT(-63.728047 47.637685)",1972,1994,22,"14",10519
"POINT(-70.87637 46.85767)",2016,2021,5,"6",16233
"POINT(-60.310565 49.696327)",1990,2012,22,"23",11282
"POINT(-65.098835 42.729563)",1970,1994,24,"25",10567
"POINT(-53.864595 53.910492)",1971,1994,23,"18",10387
"POINT(-57.690888 43.437611)",1974,1992,18,"3",10713
"POINT(-65.562778 46.995278)",2011,2014,3,"2",15375
"POINT(-64.8083 47.67109)",2009,2010,1,"2",15212
"POINT(-61.56738 44.19795)",1982,1994,12,"13",11547
"POINT(-63.06152 46.75491)",1978,2018,40,"41",14494
"POINT(-61.56738 44.19795)",1996,2008,12,"9",11866
"POINT(-48.33984 44.59046)",1977,2000,23,"24",14137
"POINT(-65.090012 44.451082)",1996,1997,1,"2",14052
"POINT(-69 43)",1967,1989,22,"23",13419
"POINT(-57.690888 43.437611)",1970,1994,24,"20",10279
"POINT(-62.11238 46.383134)",2004,2010,6,"7",15345
"POINT(-70.87637 46.85767)",2019,2020,1,"2",15912
"POINT(-75.363333 35.224444)",1992,1993,1,"2",12728
"POINT(-86 50)",1970,2014,44,"45",12690
"POINT(-61.56738 44.19795)",1995,2016,21,"22",11791
"POINT(-78.5 45.58333)",1977,1988,11,"12",10127
"POINT(-62.547863 46.172776)",2011,2014,3,"2",15505
"POINT(-63.06152 46.75491)",1978,2018,40,"41",14802
"POINT(-70.87637 46.85767)",2017,2020,3,"2",16226
"POINT(-65.3 43)",1970,1997,27,"28",13239
"POINT(-59 49.25)",1965,2017,52,"53",14751
"POINT(-65.63232 43.2452)",1980,2008,28,"29",14355
"POINT(-48.33984 44.59046)",1977,2000,23,"24",14187
"POINT(-69.041914 40.95268)",1969,2008,39,"40",14700
"POINT(-63.277839 64.284513)",2005,2008,3,"4",14986
"POINT(-54.93333 49.28333)",1993,2010,17,"18",11220
"POINT(-61.56738 44.19795)",1995,2016,21,"22",11467
"POINT(-64.710486 46.475972)",2004,2010,6,"7",15421
"POINT(-62.067902 49.652037)",1985,1989,4,"3",10703
"POINT(-61.56738 44.19795)",1995,2016,21,"10",12075
"POINT(-65.098835 42.729563)",1985,1987,2,"3",11023
"POINT(-55.995809 46.034584)",1970,1993,23,"23",10591
"POINT(-77.229936 44.152886)",1992,2018,26,"27",13650
"POINT(-63 47)",1978,1990,12,"13",13184
"POINT(-84.499722 49.25)",1995,2004,9,"9",9986
"POINT(-53.37158 51.46769)",1979,2011,32,"33",14497
"POINT(-58.635512 47.364248)",1971,1994,23,"20",10912
"POINT(-50.839607 46.393875)",1960,2010,50,"51",11273
"POINT(-61.181309 42.866877)",1970,1994,24,"22",11095
"POINT(-61.56738 44.19795)",1995,2016,21,"22",11718
"POINT(-73.107078 52.941847)",1970,2014,44,"45",12709
"POINT(-74.381869 45.160229)",1990,2018,28,"3",14036
"POINT(-58.635512 47.364248)",1971,1994,23,"21",10310
"POINT(-65.50048 43.2532)",1982,1994,12,"13",11753
"POINT(-72.82857 45.04889)",2016,2021,5,"3",15998
"POINT(-61.56738 44.19795)",1970,1981,11,"12",11662
"POINT(-69.959722 41.681944)",1960,2009,49,"50",12992
"POINT(-69.666667 48.15)",1994,2005,11,"12",12900
"POINT(-76.26806 36.03472)",1991,2001,10,"11",9950
"POINT(-65.098835 42.729563)",1970,1994,24,"25",11069
"POINT(-58.93 43.84)",1988,2011,23,"18",15850
"POINT(-74.018383 39.10066)",1982,2015,33,"34",14733
"POINT(-62.511072 46.018891)",2011,2014,3,"2",15362
"POINT(-61.56738 44.19795)",1982,1994,12,"13",11537
"POINT(-64.657552 47.746584)",2004,2007,3,"3",15788
"POINT(-61.56738 44.19795)",1995,2016,21,"22",11681
"POINT(-65.50048 43.2532)",1995,2016,21,"22",12125
"POINT(-61.56738 44.19795)",1995,2016,21,"22",12364
"POINT(-78.291582 43.944964)",1987,2016,29,"30",14024
"POINT(-69.66667 48)",1977,1997,20,"8",13117
"POINT(-74.381869 45.160229)",1998,2016,18,"5",13951
"POINT(-82.517801 41.970728)",2002,2003,1,"2",15033
"POINT(-68.21667 44.35)",1957,2002,45,"3",10001
"POINT(-64.861867 46.665292)",2011,2014,3,"2",15172
"POINT(-79.361398 43.62142)",2006,2012,6,"4",13527
"POINT(-65.50048 43.2532)",1970,1981,11,"12",11422
"POINT(-59.853639 59.286076)",1978,1991,13,"6",10598
"POINT(-61.181309 42.866877)",1970,1994,24,"21",10433
"POINT(-52.121122 50.695322)",1971,1993,22,"9",10429
"POINT(-65.50048 43.2532)",1982,1994,12,"13",11342
"POINT(-69.041914 40.95268)",1969,2008,39,"40",14448
"POINT(-72 40)",1973,2016,43,"44",14529
"POINT(-67.86528 44.36722)",1968,1998,30,"26",9948
"POINT(-74.381869 45.160229)",1998,2010,12,"2",13955
"POINT(-63.728047 47.637685)",1971,1994,23,"22",10879
"POINT(-84.52551 50.219196)",2016,2017,1,"2",14994
"POINT(-65.50048 43.2532)",1982,1994,12,"13",12062
"POINT(-48.319336 48.138699)",1996,2010,14,"15",14874
"POINT(-63.446958 46.46855)",2004,2009,5,"2",15133
"POINT(-77.22225 44.149251)",2001,2015,14,"9",13849
"POINT(-62.4353 54.17529)",1980,2016,36,"10",12738
"POINT(-71.71751 46.41901)",2016,2017,1,"2",16164
"POINT(-63.446958 46.46855)",2011,2014,3,"2",15657
"POINT(-55.3 46)",1959,1993,34,"35",13264
"POINT(-66.214847 41.627502)",1986,1993,7,"7",10444
"POINT(-75.363333 35.224444)",1992,1993,1,"2",12725
"POINT(-64.873712 47.473463)",2005,2010,5,"6",15757
"POINT(-77.59299 44.01301)",2008,2015,7,"2",13866
"POINT(-72.47958 46.88236)",2016,2021,5,"2",16108
"POINT(-63.728047 47.637685)",1970,1994,24,"10",10674
"POINT(-68.615921 41.275324)",1963,2005,42,"43",14324
"POINT(-61.56738 44.19795)",1984,1993,9,"4",12146
"POINT(-52.121122 50.695322)",1973,1987,14,"4",10344
"POINT(-62.74132 45.67583)",2005,2010,5,"5",15059
"POINT(-85.58269 49.249515)",1981,1984,3,"4",15815
"POINT(-76.794435 44.062208)",1992,2018,26,"27",13621
"POINT(-80.249444 42.566667)",1998,2002,4,"5",15831
"POINT(-61.56738 44.19795)",1995,2016,21,"20",12010
"POINT(-58.452138 49.69674)",1972,1993,21,"15",11043
"POINT(-76.06 44.055)",1976,2015,39,"39",13038
"POINT(-56.383301 46.711721)",1984,1991,7,"5",14894
"POINT(-82.53278 41.96694)",1991,1994,3,"4",13001
"POINT(-83.05 42.033333)",1975,2004,29,"29",12896
"POINT(-65.50048 43.2532)",1995,2016,21,"22",12354
"POINT(-57.690888 43.437611)",1978,1993,15,"15",11013
"POINT(-53.75 49.36667)",2000,2003,3,"3",11184
"POINT(-77.22225 44.149251)",2001,2015,14,"13",13596
"POINT(-77.396972 43.506083)",1997,2018,21,"9",13925
"POINT(-71.71751 46.41901)",2017,2021,4,"3",16145
"POINT(-52.121122 50.695322)",1970,1993,23,"21",11048
"POINT(-86 50)",1970,2014,44,"45",12761
"POINT(-63.728047 47.637685)",1970,1994,24,"25",10133
"POINT(-73.43806 38.53306)",1963,2009,46,"47",14754
"POINT(-61.56738 44.19795)",1983,1993,10,"8",12587
"POINT(-61.56738 44.19795)",1998,2006,8,"3",11444
"POINT(-65.50048 43.2532)",1995,2016,21,"22",12370
"POINT(-63.728047 47.637685)",1970,1994,24,"25",10141
"POINT(-83.05 42.033333)",1974,2004,30,"30",12920
"POINT(-79.85068 43.28331)",2006,2014,8,"5",13898
"POINT(-59.12841 47.47266)",1974,2010,36,"37",14440
"POINT(-65.50048 43.2532)",1999,2013,14,"3",11979
"POINT(-68.615921 41.275324)",1950,2016,66,"67",14768
"POINT(-58.452138 49.69674)",1970,1994,24,"24",10511
"POINT(-61.455567 46.07815)",2004,2010,6,"7",15645
"POINT(-61.56738 44.19795)",1985,1994,9,"8",11972
"POINT(-72.82857 45.04889)",2016,2021,5,"3",15871
"POINT(-65.50048 43.2532)",1982,1994,12,"13",12355
"POINT(-61.56738 44.19795)",2011,2015,4,"2",12043
"POINT(-79.361398 43.62142)",2006,2012,6,"4",13583
"POINT(-77.396972 43.506083)",1997,2018,21,"9",13967
"POINT(-74.018383 39.10066)",1968,2011,43,"44",14790
"POINT(-65.50048 43.2532)",1970,1981,11,"12",12428
"POINT(-61.56738 44.19795)",1970,1981,11,"12",11927
"POINT(-61.56738 44.19795)",1974,1981,7,"6",11982
"POINT(-56.766309 56.477534)",1978,1991,13,"7",10823
"POINT(-64.657552 47.746584)",2007,2010,3,"2",15685
"POINT(-63 47)",1978,1990,12,"13",13310
"POINT(-65.50048 43.2532)",1995,2016,21,"22",11411
"POINT(-68.615921 41.275324)",1950,2007,57,"58",14739
"POINT(-65.50048 43.2532)",1995,2016,21,"22",11721
"POINT(-61.56738 44.19795)",1999,2014,15,"9",11907
"POINT(-59.348941 46.441917)",1977,1994,17,"11",10305
"POINT(-72.82857 45.04889)",2016,2021,5,"2",15978
"POINT(-72.88129 46.69751)",2016,2021,5,"6",15996
"POINT(-73.95 38.73333)",1968,2006,38,"39",14829
"POINT(-64.951922 46.75123)",2011,2014,3,"2",15731
"POINT(-72.82857 45.04889)",2016,2021,5,"2",15943
"POINT(-73.107078 52.941847)",1970,2014,44,"45",12886
"POINT(-51.3 44.3)",1968,1986,18,"19",13193
"POINT(-64.34864 48.90011)",1995,2016,21,"2",14832
"POINT(-61.56738 44.19795)",1974,1981,7,"6",11715
"POINT(-50 43.083333)",1997,2011,14,"15",13433
"POINT(-65.50048 43.2532)",1995,2016,21,"21",11383
"POINT(-61.56738 44.19795)",1970,1981,11,"12",12086
"POINT(-65.50048 43.2532)",1970,1981,11,"12",11432
"POINT(-61.56738 44.19795)",1995,2016,21,"15",11579
"POINT(-65.50048 43.2532)",1995,2016,21,"22",11621
"POINT(-70.87637 46.85767)",2016,2021,5,"6",16046
"POINT(-64.951922 46.75123)",2004,2010,6,"7",15630
"POINT(-65.029957 47.777114)",2011,2014,3,"2",15260
"POINT(-52.757812 52.054271)",1995,2009,14,"15",14957
"POINT(-65.562778 46.995278)",2004,2010,6,"7",15455
"POINT(-65.50048 43.2532)",1996,2016,20,"12",11843
"POINT(-59.348941 46.441917)",1970,1994,24,"25",10772
"POINT(-65.25 44.333333)",1996,1997,1,"2",14075
"POINT(-74.381869 45.160229)",1998,2010,12,"2",14018
"POINT(-62.547863 46.172776)",2011,2014,3,"2",15194
"POINT(-48.319336 48.138699)",1996,2010,14,"15",14947
"POINT(-65.50048 43.2532)",1982,1994,12,"13",11522
"POINT(-61.455567 46.07815)",2011,2014,3,"2",15163
"POINT(-65.50048 43.2532)",1982,1994,12,"13",11460
"POINT(-69 43)",1967,1989,22,"23",13418
"POINT(-71.71751 46.41901)",2017,2021,4,"5",16075
"POINT(-75.348421 39.407679)",1961,2013,52,"53",11130
"POINT(-61.56738 44.19795)",1982,1994,12,"13",11468
"POINT(-53.864595 53.910492)",1970,1994,24,"24",10274
"POINT(-68.615921 41.275324)",1963,2005,42,"43",14398
"POINT(-65.50048 43.2532)",1995,2016,21,"22",12286
"POINT(-61.56738 44.19795)",1970,1981,11,"12",12484
"POINT(-66.214847 41.627502)",1987,1993,6,"4",10291
"POINT(-64.554866 46.218937)",2011,2014,3,"2",15356
"POINT(-74.018383 39.10066)",1975,2005,30,"31",14345
"POINT(-65.50048 43.2532)",2001,2015,14,"4",11747
"POINT(-77.547686 43.947746)",1992,2018,26,"27",13746
"POINT(-80.98194 43.37)",1992,1994,2,"3",13004
"POINT(-79.146454 46.634905)",2002,2004,2,"3",10101
"POINT(-61.181309 42.866877)",1970,1994,24,"25",10506
"POINT(-52 50)",1962,1992,30,"31",13315
"POINT(-61.56738 44.19795)",1982,1994,12,"13",11557
"POINT(-52.782383 44.683779)",1970,1994,24,"21",10610
"POINT(-63.888896 46.512101)",2009,2010,1,"2",15218
"POINT(-65.63232 43.2452)",1970,2002,32,"33",14310
"POINT(-64.11454 46.1827)",2009,2010,1,"2",15227
"POINT(-65.50048 43.2532)",1995,2016,21,"22",12099
"POINT(-53.183333 49.75)",2000,2003,3,"3",11179
"POINT(-73.107078 52.941847)",1970,2014,44,"45",12800
"POINT(-65.50048 43.2532)",1986,1988,2,"2",12518
"POINT(-61.56738 44.19795)",1970,1981,11,"9",12588
"POINT(-73.43806 38.53306)",1963,2009,46,"47",14446
"POINT(-61.455567 46.07815)",2004,2006,2,"3",15456
"POINT(-57.690888 43.437611)",1970,1994,24,"24",10195
"POINT(-65.50048 43.2532)",1982,1994,12,"13",12229
"POINT(-68.615921 41.275324)",1963,2005,42,"43",14297
"POINT(-73.107078 52.941847)",1970,2014,44,"45",12805
"POINT(-61 46.5)",1950,1989,39,"34",13128
"POINT(-61.56738 44.19795)",1995,2016,21,"22",11456
"POINT(-61.56738 44.19795)",1982,1994,12,"9",12011
"POINT(-73.93333 40.15)",1995,1999,4,"5",15865
"POINT(-61.56738 44.19795)",1970,1981,11,"12",11885
"POINT(-72 54)",1970,2014,44,"45",12846
"POINT(-72.47958 46.88236)",2016,2021,5,"2",16112
"POINT(-48.319336 48.138699)",1984,1995,11,"12",14877
"POINT(-73.19306 45.5675)",1966,1976,10,"10",12980
"POINT(-83.05 42.033333)",1975,2004,29,"29",12894
"POINT(-71.093778 40.671798)",1968,2006,38,"39",14227
"POINT(-77.072526 44.096244)",1992,2018,26,"27",13670
"POINT(-63.877945 50.078295)",1987,2008,21,"22",11144
"POINT(-48.319336 48.138699)",1984,1995,11,"12",14878
"POINT(-72.82857 45.04889)",2016,2021,5,"2",16194
"POINT(-57.690888 43.437611)",1970,1994,24,"25",10660
"POINT(-78.291582 43.944964)",1987,2016,29,"30",13940
"POINT(-78.523333 45.595278)",1972,1991,19,"19",12951
"POINT(-75.98472 44.35056)",1983,1996,13,"14",15839
"POINT(-65.50048 43.2532)",1995,2016,21,"12",11758
"POINT(-63 47)",1971,2016,45,"46",10021
"POINT(-61.56738 44.19795)",1982,1994,12,"13",12539
"POINT(-60.3 44.1)",1967,1990,23,"24",13228
"POINT(-53.75 49.36667)",2000,2003,3,"3",11177
"POINT(-57.854 44.91813)",1970,2002,32,"33",14381
"POINT(-49.956886 45.114711)",1974,1994,20,"11",10352
"POINT(-82.5 42.166667)",1972,2002,30,"2",10131
"POINT(-59.12841 47.47266)",1974,2010,36,"37",14608
"POINT(-56.766309 56.477534)",1981,1991,10,"3",10767
"POINT(-55.39306 45.80582)",1996,2013,17,"13",13082
"POINT(-55.995809 46.034584)",1982,1994,12,"12",10423
"POINT(-86 50)",1965,2000,35,"8",9996
"POINT(-74.018383 39.10066)",1975,2005,30,"31",14145
"POINT(-61.56738 44.19795)",1995,2016,21,"22",11967
"POINT(-66.75 46.5)",1970,2014,44,"45",12770
"POINT(-74.381869 45.160229)",1984,2018,34,"17",13639
"POINT(-52.782383 44.683779)",1970,1987,17,"3",10709
"POINT(-84.499722 49.25)",1995,2004,9,"9",9972
"POINT(-57.690888 43.437611)",1978,1994,16,"15",10471
"POINT(-61.1985 45.9668)",1996,1997,1,"2",14101
"POINT(-72 54)",1970,2014,44,"45",12851
"POINT(-63 45)",1970,2012,42,"43",12750
"POINT(-60.3 44.1)",1967,1990,23,"24",13206
"POINT(-72.3944 45.1542)",2008,2010,2,"3",11165
"POINT(-64.11454 46.1827)",2011,2014,3,"2",15153
"POINT(-63.888896 46.512101)",2009,2010,1,"2",15591
"POINT(-66.915904 45.009168)",1970,1978,8,"9",12965
"POINT(-64.554866 46.218937)",2011,2014,3,"2",15666
"POINT(-61.56738 44.19795)",1984,1992,8,"7",12177
"POINT(-68.3 43.3)",2007,2014,7,"8",14582
"POINT(-68.615921 41.275324)",1963,2005,42,"43",14123
"POINT(-86 50)",1970,2014,44,"45",12823
"POINT(-58.452138 49.69674)",1972,1994,22,"22",10808
"POINT(-73.93333 40.15)",1995,1999,4,"5",15867
"POINT(-64.351142 48.893948)",1971,2010,39,"5",12973
"POINT(-64.646046 47.789535)",2004,2010,6,"7",15220
"POINT(-61.56738 44.19795)",1985,1994,9,"8",11705
"POINT(-61.56738 44.19795)",1983,1993,10,"6",11862
"POINT(-56.766309 56.477534)",1978,1981,3,"3",11106
"POINT(-65.50048 43.2532)",1970,1981,11,"11",12534
"POINT(-79.85068 43.28331)",2006,2015,9,"6",13843
"POINT(-61.56738 44.19795)",1995,2016,21,"20",12041
"POINT(-65.50048 43.2532)",1971,1979,8,"3",11578
"POINT(-63 45)",1970,2012,42,"43",12754
"POINT(-71.249968 47.750004)",1985,1997,12,"13",13067
"POINT(-65.50048 43.2532)",1982,1994,12,"13",12164
"POINT(-56.766309 56.477534)",1978,1988,10,"6",10329
"POINT(-55.995809 46.034584)",1974,1994,20,"10",11002
"POINT(-65.57426 46.98624)",2011,2014,3,"2",15445
"POINT(-65.3 43)",1962,1988,26,"27",13240
"POINT(-63.888896 46.512101)",2011,2014,3,"2",15365
"POINT(-85.85278 41.72556)",1991,1995,4,"5",13118
"POINT(-69.666667 48.15)",1994,2005,11,"12",12921
"POINT(-74.381869 45.160229)",1984,2018,34,"17",13696
"POINT(-72.47958 46.88236)",2016,2021,5,"2",15976
"POINT(-74.381869 45.160229)",2006,2018,12,"7",13957
"POINT(-65.50048 43.2532)",1972,1981,9,"9",11768
"POINT(-86 50)",1970,2014,44,"45",12756
"POINT(-52 50)",1962,1992,30,"31",13168
"POINT(-65.562778 46.995278)",2004,2010,6,"7",15216
"POINT(-75.363333 35.224444)",1992,1993,1,"2",12723
"POINT(-84.499722 49.25)",1995,2004,9,"9",9975
"POINT(-77.59299 44.01301)",2001,2015,14,"3",13872
"POINT(-68.615921 41.275324)",1963,2005,42,"43",14373
"POINT(-49.956886 45.114711)",1972,1993,21,"9",10286
"POINT(-86 50)",1970,2014,44,"45",12769
"POINT(-48.319336 48.138699)",1975,1982,7,"8",14952
"POINT(-71.293384 46.742075)",1975,1998,23,"24",11187
"POINT(-50.28156 53.257559)",1977,1994,17,"17",14848
"POINT(-78.291582 43.944964)",1974,1985,11,"9",13566
"POINT(-61.017433 46.6243)",2008,2010,2,"3",15124
"POINT(-61.017433 46.6243)",2011,2014,3,"2",15811
"POINT(-61.455567 46.07815)",2004,2010,6,"7",15798
"POINT(-82.448825 48.444828)",2002,2004,2,"3",10102
"POINT(-65.50048 43.2532)",1970,1981,11,"12",12121
"POINT(-52.782383 44.683779)",1970,1994,24,"23",10959
"POINT(-52 50)",1962,1992,30,"31",13357
"POINT(-61.87121 45.68314)",2011,2014,3,"2",15198
"POINT(-65.50048 43.2532)",1970,1981,11,"12",11604
"POINT(-59.853639 59.286076)",1978,1991,13,"6",10931
"POINT(-68.871657 43.27657)",1985,2016,31,"32",14771
"POINT(-65.50048 43.2532)",1982,1994,12,"13",11727
"POINT(-58.452138 49.69674)",1972,1994,22,"13",10547
"POINT(-74.018383 39.10066)",1967,2005,38,"39",14169
"POINT(-60.3 44.1)",1967,1990,23,"24",13353
"POINT(-57.41455 46.93526)",1983,2011,28,"28",14233
"POINT(-77.229936 44.152886)",1992,2018,26,"27",13604
"POINT(-52.121122 50.695322)",1970,1993,23,"17",10971
"POINT(-81.87611 45.625)",1950,1983,33,"34",13338
"POINT(-61.56738 44.19795)",1995,2016,21,"22",12538
"POINT(-63.446958 46.46855)",2004,2008,4,"4",15475
"POINT(-65.63232 43.2452)",1970,2002,32,"33",14210
"POINT(-61.56738 44.19795)",1998,2006,8,"3",12245
"POINT(-64.269444 45.140278)",1976,2010,34,"14",13100
"POINT(-65.50048 43.2532)",1982,1994,12,"13",12329
"POINT(-63.427139 46.193528)",2008,2010,2,"3",15223
"POINT(-86 50)",1970,2014,44,"45",12681
"POINT(-71.71751 46.41901)",2017,2021,4,"3",15999
"POINT(-63.728047 47.637685)",1970,1994,24,"18",10797
"POINT(-65.50048 43.2532)",1972,1981,9,"9",12302
"POINT(-81.069321 43.095367)",1995,2006,11,"12",11159
"POINT(-77.59299 44.01301)",2001,2015,14,"3",13889
"POINT(-73.795833 45.016389)",2003,2004,1,"2",13074
"POINT(-64.861867 46.665292)",2006,2010,4,"5",15402
"POINT(-70.87637 46.85767)",2016,2021,5,"6",16154
"POINT(-64.554866 46.218937)",2007,2010,3,"3",15451
"POINT(-77.072526 44.096244)",1992,2012,20,"21",13533
"POINT(-64.951922 46.75123)",2011,2014,3,"2",15283
"POINT(-68.526458 40.575228)",1964,2016,52,"53",14546
"POINT(-77.59299 44.01301)",2001,2015,14,"3",13830
"POINT(-81.469569 45.218917)",2004,2015,11,"12",12924
"POINT(-65.50048 43.2532)",1995,2016,21,"22",12621
"POINT(-66.214847 41.627502)",1980,1989,9,"3",10192
"POINT(-61.87121 45.68314)",2005,2010,5,"4",15542
"POINT(-59.348941 46.441917)",1970,1994,24,"20",10435
"POINT(-52.121122 50.695322)",1970,1994,24,"24",10180
"POINT(-58.452138 49.69674)",1978,1992,14,"7",10384
"POINT(-65.62222 47.65259)",2009,2010,1,"2",15654
"POINT(-64.554866 46.218937)",2011,2014,3,"2",15441
"POINT(-61.56738 44.19795)",1995,2016,21,"22",12640
"POINT(-57.690888 43.437611)",1970,1994,24,"25",10648
"POINT(-79.85068 43.28331)",2006,2015,9,"6",13894
"POINT(-65.50048 43.2532)",1995,2016,21,"22",12266
"POINT(-66.291594 46.666605)",1970,2014,44,"45",12884
"POINT(-65.50048 43.2532)",1983,1991,8,"6",11778
"POINT(-67.61672 66.56356)",1999,2014,15,"3",12649
"POINT(-73.43806 38.53306)",1963,2009,46,"47",14726
"POINT(-62.74132 45.67583)",2004,2010,6,"7",15113
"POINT(-55.995809 46.034584)",1974,1994,20,"17",10350
"POINT(-58.452138 49.69674)",1971,1994,23,"23",10254
"POINT(-73.946667 41.868056)",1985,1996,11,"12",9994
"POINT(-62.067902 49.652037)",1984,1988,4,"5",11110
"POINT(-61.56738 44.19795)",1995,2016,21,"22",12234
"POINT(-65.50048 43.2532)",1996,2016,20,"18",12074
"POINT(-61.56738 44.19795)",1995,2016,21,"22",11941
"POINT(-67.897873 41.030255)",1991,2006,15,"16",9953
"POINT(-65.50048 43.2532)",1995,2014,19,"17",12350
"POINT(-61.56738 44.19795)",1995,2016,21,"22",11674
"POINT(-65.50048 43.2532)",1970,1981,11,"12",12474
"POINT(-84.499722 49.25)",1995,2005,10,"11",9982
"POINT(-59.348941 46.441917)",1977,1994,17,"11",11053
"POINT(-53.37158 51.46769)",1979,2011,32,"33",14441
"POINT(-65.50048 43.2532)",1982,1994,12,"13",12020
"POINT(-53.864595 53.910492)",1973,1994,21,"10",11022
"POINT(-63.728047 47.637685)",1984,1988,4,"5",11109
"POINT(-74.018383 39.10066)",1967,2005,38,"39",14194
"POINT(-65.562778 46.995278)",2011,2014,3,"2",15700
"POINT(-61.56738 44.19795)",1982,1994,12,"13",12123
"POINT(-71.093778 40.671798)",1967,2005,38,"39",14325
"POINT(-62.067902 49.652037)",1974,1990,16,"11",10267
"POINT(-76.794435 44.062208)",1992,2018,26,"27",13676
"POINT(-52.121122 50.695322)",1970,1994,24,"23",10259
"POINT(-51.3 44.3)",1968,1986,18,"19",13277
"POINT(-52.121122 50.695322)",1978,1986,8,"4",10783
"POINT(-65.50048 43.2532)",1970,1981,11,"12",11796
"POINT(-82.517801 41.970728)",2002,2003,1,"2",15011
"POINT(-65.50048 43.2532)",1970,1981,11,"12",11356
"POINT(-63.802767 46.136433)",2011,2014,3,"2",15750
"POINT(-62.067902 49.652037)",1985,1994,9,"6",10524
"POINT(-84.52551 50.219196)",2016,2017,1,"2",14991
"POINT(-61.455567 46.07815)",2004,2010,6,"7",15118
"POINT(-68.615921 41.275324)",1950,2007,57,"58",14515
"POINT(-77.59299 44.01301)",2001,2015,14,"3",13820
"POINT(-55.995809 46.034584)",1970,1994,24,"24",10461
"POINT(-74.381869 45.160229)",1988,2014,26,"3",13958
"POINT(-49.931212 51.171824)",1983,2015,32,"33",12650
"POINT(-59.822611 42.550438)",1970,1980,10,"8",11247
"POINT(-59.12841 47.47266)",1974,2010,36,"37",14496
"POINT(-72.88129 46.69751)",2017,2021,4,"4",16219
"POINT(-74.018383 39.10066)",1971,2016,45,"46",14508
"POINT(-68.615921 41.275324)",1963,2009,46,"47",14765
"POINT(-52.77293 47.262571)",1979,2001,22,"4",14816
"POINT(-86 50)",1970,2014,44,"45",12860
"POINT(-63.165833 46.420833)",2011,2014,3,"2",15506
"POINT(-63.728047 47.637685)",1976,1994,18,"4",10347
"POINT(-73.107078 52.941847)",1970,2014,44,"45",12879
"POINT(-82.517801 41.970728)",2002,2003,1,"2",15038
"POINT(-63 47)",1978,1990,12,"13",13415
"POINT(-64.646046 47.789535)",2011,2014,3,"2",15164
"POINT(-61.017433 46.6243)",2011,2014,3,"2",15259
"POINT(-67 43)",1970,2010,40,"41",14339
"POINT(-71.093778 40.671798)",1968,2006,38,"39",14202
"POINT(-61.56738 44.19795)",1995,2016,21,"22",12084
"POINT(-59.348941 46.441917)",1973,1994,21,"12",11061
"POINT(-72.82857 45.04889)",2016,2021,5,"3",15956
"POINT(-68.871657 43.27657)",1982,2014,32,"33",14651
"POINT(-68.615921 41.275324)",1963,2016,53,"54",14596
"POINT(-61.181309 42.866877)",1991,1993,2,"3",10642
"POINT(-79.361398 43.62142)",2006,2012,6,"4",13507
"POINT(-65.50048 43.2532)",1985,1993,8,"2",12454
"POINT(-86 50)",1970,2014,44,"45",12682
"POINT(-72.88129 46.69751)",2017,2019,2,"2",16220
"POINT(-72.82857 45.04889)",2016,2021,5,"3",16133
"POINT(-79.361398 43.62142)",2006,2012,6,"4",13547
"POINT(-67.064717 44.266029)",1982,1993,11,"5",10373
"POINT(-77.396957 43.50608)",1978,2018,40,"40",13966
"POINT(-52.813605 47.187621)",1979,1997,18,"2",14810
"POINT(-65.50048 43.2532)",1970,1981,11,"12",11966
"POINT(-68.615921 41.275324)",1950,2007,57,"58",14683
"POINT(-76.794435 44.062208)",1992,2018,26,"27",13624
"POINT(-77.396972 43.506083)",1997,2018,21,"9",14009
"POINT(-65.50048 43.2532)",1982,1988,6,"5",11516
"POINT(-74.018383 39.10066)",1967,2005,38,"39",14219
"POINT(-61.652594 43.355895)",1970,2010,40,"41",11271
"POINT(-77.59299 44.01301)",2001,2015,14,"3",13896
"POINT(-78.523333 45.595278)",1952,1995,43,"43",12945
"POINT(-48.319336 48.138699)",1996,2010,14,"15",14922
"POINT(-63.427139 46.193528)",2008,2010,2,"3",15122
"POINT(-58.452138 49.69674)",1984,1994,10,"10",10298
"POINT(-61.56738 44.19795)",1995,2016,21,"22",12243
"POINT(-55.3 46)",1959,1993,34,"35",13327
"POINT(-58.02978 50.13466)",1973,2003,30,"31",14217
"POINT(-77.22225 44.149251)",2001,2015,14,"14",13587
"POINT(-61.56738 44.19795)",1985,1994,9,"8",11438
"POINT(-74.018383 39.10066)",1982,2015,33,"34",14593
"POINT(-69.041914 40.95268)",1967,2014,47,"48",14533
"POINT(-65.50048 43.2532)",1982,1994,12,"13",12499
"POINT(-55.995809 46.034584)",1974,1994,20,"7",10526
"POINT(-82.517801 41.970728)",2002,2003,1,"2",15012
"POINT(-58.93 43.84)",1988,2011,23,"18",15848
"POINT(-64.710486 46.475972)",2004,2010,6,"7",15603
"POINT(-65.63232 43.2452)",1970,2010,40,"41",14386
"POINT(-72.82857 45.04889)",2016,2021,5,"3",16111
"POINT(-63.2 42)",1973,1986,13,"14",13392
"POINT(-65.50048 43.2532)",1982,1994,12,"8",11390
"POINT(-79.85068 43.28331)",2006,2015,9,"6",13870
"POINT(-52.772629 43.876179)",2005,2008,3,"4",11239
"POINT(-67 43)",1970,2010,40,"41",14114
"POINT(-50.3 44.3)",1965,1986,21,"22",13389
"POINT(-52.121122 50.695322)",1973,1994,21,"7",11021
"POINT(-70.87637 46.85767)",2017,2021,4,"3",16006
"POINT(-61.164851 45.857738)",1996,1997,1,"2",14071
"POINT(-66.254263 48.944718)",1983,2008,25,"26",14998
"POINT(-79.361398 43.62142)",2006,2012,6,"4",13520
"POINT(-68.526458 40.575228)",1982,2016,34,"35",14563
"POINT(-57.690888 43.437611)",1970,1994,24,"25",10829
"POINT(-61.56738 44.19795)",1970,1981,11,"12",11393
"POINT(-63.728047 47.637685)",1971,1994,23,"24",10758
"POINT(-76.794435 44.062208)",1992,2012,20,"21",13508
"POINT(-69.041914 40.95268)",1984,2016,32,"33",14643
"POINT(-62.74132 45.67583)",2011,2014,3,"2",15248
"POINT(-52.121122 50.695322)",1973,1994,21,"18",10578
"POINT(-74.018383 39.10066)",1971,2016,45,"46",14676
"POINT(-65.50048 43.2532)",1970,1981,11,"11",12432
"POINT(-65.50048 43.2532)",1995,2016,21,"22",11427
"POINT(-74.018383 39.10066)",1971,2016,45,"46",14480
"POINT(-48.319336 48.138699)",1975,1982,7,"8",14857
"POINT(-74.381869 45.160229)",1984,2016,32,"16",13640
"POINT(-67.5 40.4)",1955,1987,32,"33",13236
"POINT(-77.229936 44.152886)",1992,2018,26,"27",13586
"POINT(-78.523333 45.595278)",1952,1995,43,"43",12949
"POINT(-61.56738 44.19795)",1995,2016,21,"22",12064
"POINT(-65.50048 43.2532)",1970,1981,11,"12",11995
"POINT(-66.214847 41.627502)",1988,1993,5,"5",10217
"POINT(-61.56738 44.19795)",1982,1994,12,"13",11942
"POINT(-67.86528 44.36722)",1968,1998,30,"26",9949
"POINT(-61.56738 44.19795)",1995,2016,21,"22",12263
"POINT(-64.269444 45.140278)",1976,2010,34,"14",13097
"POINT(-64.873712 47.473463)",2005,2010,5,"6",15313
"POINT(-65.098835 42.729563)",1971,1994,23,"11",10469
"POINT(-65.50048 43.2532)",1995,2016,21,"22",11912
"POINT(-74.381869 45.160229)",1984,2014,30,"6",14001
"POINT(-49.931212 51.171824)",1983,2011,28,"29",14234
"POINT(-69 43)",1967,1989,22,"23",13334
"POINT(-61.56738 44.19795)",1995,2015,20,"12",11628
"POINT(-72.47958 46.88236)",2016,2021,5,"2",16084
"POINT(-66.214847 41.627502)",1981,1992,11,"5",10875
"POINT(-74.381869 45.160229)",1984,2018,34,"17",13699
"POINT(-63.06152 46.75491)",1978,2018,40,"41",14439
"POINT(-65.098835 42.729563)",1975,1987,12,"6",10995
"POINT(-63.446958 46.46855)",2004,2005,1,"2",15553
"POINT(-72.47958 46.88236)",2016,2021,5,"2",16197
"POINT(-63.126667 46.235)",1998,1999,1,"2",14979
"POINT(-72.82857 45.04889)",2016,2021,5,"2",16119
"POINT(-63.427139 46.193528)",2011,2014,3,"2",15257
"POINT(-75.363333 35.224444)",1992,1993,1,"2",12653
"POINT(-61.56738 44.19795)",1995,2016,21,"22",11470
"POINT(-62.735984 45.290147)",1970,2014,44,"45",12868
"POINT(-58.452138 49.69674)",1970,1994,24,"24",10208
"POINT(-56.383301 46.711721)",1972,1982,10,"10",14969
"POINT(-61.56738 44.19795)",1970,1981,11,"12",12265
"POINT(-59.348941 46.441917)",1970,1994,24,"20",10868
"POINT(-64.951922 46.75123)",2011,2014,3,"2",15662
"POINT(-64.7 43.374167)",1983,2008,25,"26",11242
"POINT(-79.85068 43.28331)",2006,2015,9,"6",13842
"POINT(-74.381869 45.160229)",1998,2010,12,"2",13913
"POINT(-61.56738 44.19795)",1971,1981,10,"6",12190
"POINT(-71.71751 46.41901)",2016,2021,5,"6",16116
"POINT(-62.067902 49.652037)",1980,1993,13,"4",10981
"POINT(-62.735984 45.290147)",1970,2012,42,"43",12749
"POINT(-55.995809 46.034584)",1973,1994,21,"13",10734
"POINT(-74.381869 45.160229)",2012,2018,6,"4",13935
"POINT(-62.735984 45.290147)",1970,2012,42,"43",12755
"POINT(-64.646046 47.789535)",2004,2010,6,"7",15089
"POINT(-64.951922 46.75123)",2004,2010,6,"7",15273
"POINT(-55.995809 46.034584)",1977,1994,17,"17",10695
"POINT(-59.348941 46.441917)",1977,1984,7,"6",10227
"POINT(-62.067902 49.652037)",1979,1994,15,"12",10663
"POINT(-74.381869 45.160229)",1984,2018,34,"10",14013
"POINT(-55.995809 46.034584)",1970,1994,24,"24",10309
"POINT(-63.728047 47.637685)",1970,1994,24,"25",10149
"POINT(-62.511072 46.018891)",2005,2010,5,"6",15588
"POINT(-63.902612 46.237205)",2002,2006,4,"4",10074
"POINT(-78.733333 50.2)",2001,2009,8,"9",12929
"POINT(-74.381869 45.160229)",1988,2014,26,"3",13916
"POINT(-55.995809 46.034584)",1970,1994,24,"24",11018
"POINT(-62.067902 49.652037)",1983,1994,11,"11",10480
"POINT(-64.11454 46.1827)",2011,2014,3,"2",15503
"POINT(-77.229936 44.152886)",1992,2018,26,"27",13721
"POINT(-62.511072 46.018891)",2005,2010,5,"5",15524
"POINT(-50 43.083333)",1997,2011,14,"15",13441
"POINT(-65.50048 43.2532)",1983,1994,11,"12",11741
"POINT(-53.864595 53.910492)",1971,1994,23,"20",10822
"POINT(-62.511072 46.018891)",2006,2010,4,"2",15483
"POINT(-65.50048 43.2532)",1983,1994,11,"12",12008
"POINT(-61.181309 42.866877)",1970,1994,24,"25",10158
"POINT(-57.771263 49.761184)",1971,2011,40,"41",11301
"POINT(-63.728047 47.637685)",1978,1988,10,"6",10306
"POINT(-65.50048 43.2532)",1995,2016,21,"22",12527
"POINT(-86 50)",1970,2014,44,"45",12781
"POINT(-53.864595 53.910492)",1970,1994,24,"24",10182
"POINT(-52 50)",1962,1992,30,"31",13273
"POINT(-65.50048 43.2532)",1982,1994,12,"13",12496
"POINT(-48.319336 48.138699)",1996,2010,14,"15",14923
"POINT(-63.739472 45.85055)",2005,2009,4,"5",15108
"POINT(-55.995809 46.034584)",1970,1994,24,"24",10171
"POINT(-76.794435 44.062208)",1992,2018,26,"27",13735
"POINT(-72.88129 46.69751)",2016,2021,5,"6",15977
"POINT(-53.864595 53.910492)",1973,1994,21,"21",10396
"POINT(-59.348941 46.441917)",1970,1992,22,"6",10381
"POINT(-77.22225 44.149251)",2001,2015,14,"9",13783
"POINT(-63.802767 46.136433)",2005,2010,5,"6",15127
"POINT(-76.06 44.055)",1976,2015,39,"40",13054
"POINT(-69.041914 40.95268)",1967,2014,47,"48",14757
"POINT(-79.361398 43.62142)",2006,2012,6,"4",13504
"POINT(-52.782383 44.683779)",1975,1994,19,"16",10198
"POINT(-61.181309 42.866877)",1970,1994,24,"25",10191
"POINT(-63 47)",1978,1990,12,"13",13351
"POINT(-61.87121 45.68314)",2004,2010,6,"7",15346
"POINT(-72.88129 46.69751)",2016,2021,5,"6",15870
"POINT(-55.995809 46.034584)",1970,1994,24,"24",10154
"POINT(-64.861867 46.665292)",2006,2010,4,"3",15136
"POINT(-61.56738 44.19795)",1972,1981,9,"6",11538
"POINT(-63 47)",1974,2016,42,"31",10035
"POINT(-59.853639 59.286076)",1978,1991,13,"3",10630
"POINT(-63.446958 46.46855)",2011,2014,3,"2",15184
"POINT(-61.017433 46.6243)",2009,2010,1,"2",15437
"POINT(-74.58861 36.44722)",1985,2014,29,"30",14492
"POINT(-61.455567 46.07815)",2008,2010,2,"2",15773
"POINT(-68.871657 43.27657)",1985,2016,31,"32",14463
"POINT(-62.067902 49.652037)",1973,1994,21,"18",10870
"POINT(-65.098835 42.729563)",1985,1987,2,"3",10416
"POINT(-63.902612 46.237205)",2001,2006,5,"6",10090
"POINT(-73.43806 38.53306)",1963,2009,46,"47",14614
"POINT(-65.50048 43.2532)",1995,2016,21,"22",11694
"POINT(-65.63232 43.2452)",1970,2007,37,"38",14304
"POINT(-54.35691 48.45157)",2015,2016,1,"2",11308
"POINT(-48.319336 48.138699)",1996,2010,14,"15",14972
"POINT(-67.064717 44.266029)",1971,1991,20,"16",10741
"POINT(-49.931212 51.171824)",1983,2011,28,"29",14284
"POINT(-72.88129 46.69751)",2018,2019,1,"2",15904
"POINT(-63.802767 46.136433)",2005,2010,5,"6",15419
"POINT(-65.50048 43.2532)",1982,1994,12,"13",12363
"POINT(-71.71751 46.41901)",2018,2021,3,"4",15902
"POINT(-61.56738 44.19795)",1997,2016,19,"20",12282
"POINT(-59.348941 46.441917)",1977,1994,17,"13",10570
"POINT(-63 47)",1978,1990,12,"13",13414
"POINT(-63.728047 47.637685)",1970,1994,24,"25",10894
"POINT(-75.149444 39.05)",1982,2006,24,"23",11189
"POINT(-74.018383 39.10066)",1973,2002,29,"30",14146
"POINT(-57.854 44.91813)",1970,2002,32,"33",14356
"POINT(-63.877945 50.078295)",1987,2008,21,"22",11145
"POINT(-65.50048 43.2532)",1982,1994,12,"13",12602
"POINT(-63.728047 47.637685)",1973,1990,17,"7",10358
"POINT(-52.121122 50.695322)",1978,1985,7,"3",10890
"POINT(-65.57426 46.98624)",2008,2010,2,"3",15414
"POINT(-60.722076 46.7213)",2001,2015,14,"7",11134
"POINT(-71.71751 46.41901)",2018,2021,3,"4",16212
"POINT(-61.56738 44.19795)",2010,2014,4,"2",11896
"POINT(-50.75978 47.607599)",1970,1994,24,"25",10163
"POINT(-64.573724 46.34102)",2004,2010,6,"7",15337
"POINT(-65.50048 43.2532)",1995,2016,21,"20",12344
"POINT(-79.361398 43.62142)",2006,2012,6,"4",13505
"POINT(-75.53 35.224444)",1992,1993,1,"2",12732
"POINT(-55.995809 46.034584)",1970,1994,24,"24",10872
"POINT(-57.690888 43.437611)",1970,1992,22,"10",10672
"POINT(-63.728047 47.637685)",1972,1991,19,"12",10221
"POINT(-65.098835 42.729563)",1970,1993,23,"24",10584
"POINT(-86 50)",1970,2014,44,"45",12855
"POINT(-82.517801 41.970728)",2002,2003,1,"2",15013
"POINT(-77.229936 44.152886)",1992,2018,26,"27",13768
"POINT(-65.62222 47.65259)",2009,2010,1,"2",15130
"POINT(-55.995809 46.034584)",1974,1988,14,"3",10452
"POINT(-59.12841 47.47266)",1974,2010,36,"37",14664
"POINT(-86 50)",1970,2014,44,"45",12788
"POINT(-61.56738 44.19795)",1989,1993,4,"2",12477
"POINT(-65.50048 43.2532)",1971,1979,8,"3",12379
"POINT(-62.067902 49.652037)",1978,1994,16,"11",10651
"POINT(-74.381869 45.160229)",2012,2018,6,"4",13977
"POINT(-61.017433 46.6243)",2008,2010,2,"3",15338
"POINT(-59 49.25)",1965,2017,52,"53",14416
"POINT(-58.452138 49.69674)",1971,1994,23,"21",10573
"POINT(-65.50048 43.2532)",1995,2016,21,"22",12437
"POINT(-65.50048 43.2532)",1982,1994,12,"13",11859
"POINT(-61.164851 45.857738)",1996,1997,1,"2",14063
"POINT(-83.05 42.033333)",1975,2004,29,"29",12914
"POINT(-68.615921 41.275324)",1963,2016,53,"54",14708
"POINT(-69.666667 48.15)",1994,2005,11,"12",12897
"POINT(-61.56738 44.19795)",1995,2016,21,"22",12150
"POINT(-74.018383 39.10066)",1971,2016,45,"46",14536
"POINT(-61.56738 44.19795)",1970,1980,10,"6",11649
"POINT(-61.56738 44.19795)",1970,1981,11,"12",12532
"POINT(-71.093778 40.671798)",1989,2016,27,"28",14629
"POINT(-59 49.25)",1965,2017,52,"53",14415
"POINT(-63.188167 45.760967)",2009,2010,1,"2",15393
"POINT(-74.381869 45.160229)",1984,2016,32,"15",13759
"POINT(-77.229936 44.152886)",1992,2018,26,"27",13716
"POINT(-63.188167 45.760967)",2009,2010,1,"2",15070
"POINT(-65.50048 43.2532)",1995,2016,21,"16",11417
"POINT(-77.59299 44.01301)",2001,2015,14,"3",13853
"POINT(-66.11572 44.8247)",1997,2012,15,"16",14465
"POINT(-79.58333 42.85)",1988,1997,9,"10",11146
"POINT(-65.098835 42.729563)",1984,1993,9,"3",11065
"POINT(-61.56738 44.19795)",1984,1994,10,"10",11635
"POINT(-61.56738 44.19795)",1995,2015,20,"12",12429
"POINT(-65.50048 43.2532)",1982,1994,12,"13",12148
"POINT(-86 50)",1970,2014,44,"45",12775
"POINT(-64.873712 47.473463)",2005,2006,1,"2",15134
"POINT(-64.657552 47.746584)",2004,2010,6,"7",15632
"POINT(-72.82857 45.04889)",2016,2021,5,"2",16158
"POINT(-61.56738 44.19795)",1970,1981,11,"12",12194
"POINT(-52.782383 44.683779)",1989,1994,5,"6",10424
"POINT(-74.018383 39.10066)",1967,2005,38,"39",14294
"POINT(-71.71751 46.41901)",2017,2020,3,"2",15911
"POINT(-73.26805 45.12098)",2010,2013,3,"2",11167
"POINT(-62.547863 46.172776)",2005,2010,5,"6",15229
"POINT(-65.50048 43.2532)",1995,2016,21,"22",12386
"POINT(-63.758716 46.383956)",2007,2010,3,"4",15629
"POINT(-77.072526 44.096244)",1992,2018,26,"27",13608
"POINT(-63 43)",2001,2010,9,"10",11259
"POINT(-65.562778 46.995278)",2004,2010,6,"7",15115
"POINT(-74.381869 45.160229)",1994,2018,24,"4",14037
"POINT(-86 50)",1970,2014,44,"45",12778
"POINT(-50.3 44.3)",1965,1986,21,"22",13242
"POINT(-74.018383 39.10066)",1973,2002,29,"30",14196
"POINT(-65.50048 43.2532)",1970,1981,11,"12",12161
"POINT(-79.087009 46.416229)",2002,2004,2,"3",10115
"POINT(-75.8741 44.40811)",2005,2006,1,"2",11136
"POINT(-65.50048 43.2532)",1982,1994,12,"13",11789
"POINT(-61.56738 44.19795)",1982,1994,12,"13",11730
"POINT(-59 44.1)",1976,1990,14,"15",13216
"POINT(-61.56738 44.19795)",1972,1981,9,"2",12445
"POINT(-65.50048 43.2532)",1970,1981,11,"10",12543
"POINT(-63.126667 46.235)",1998,1999,1,"2",14983
"POINT(-64.573724 46.34102)",2011,2014,3,"2",15747
"POINT(-65.562778 46.995278)",2004,2010,6,"7",15329
"POINT(-58.452138 49.69674)",1972,1994,22,"13",10694
"POINT(-65.50048 43.2532)",1982,1994,12,"13",11405
"POINT(-70.87637 46.85767)",2019,2021,2,"3",16105
"POINT(-61.56738 44.19795)",1995,2016,21,"22",12592
"POINT(-49.956886 45.114711)",1970,1994,24,"25",10541
"POINT(-68.615921 41.275324)",1963,2005,42,"43",14174
"POINT(-48.319336 48.138699)",1985,1995,10,"11",14879
"POINT(-61.56738 44.19795)",1995,2016,21,"22",12482
"POINT(-61.181309 42.866877)",1972,1994,22,"19",11012
"POINT(-62.511072 46.018891)",2011,2014,3,"2",15374
"POINT(-62.28626 46.36766)",2008,2010,2,"3",15762
"POINT(-61.56738 44.19795)",1970,1981,11,"12",11736
"POINT(-69.66667 48)",1973,1985,12,"5",13034
"POINT(-65.50048 43.2532)",1982,1994,12,"13",11833
"POINT(-64.573724 46.34102)",2005,2010,5,"4",15053
"POINT(-79.85068 43.28331)",2014,2015,1,"2",13782
"POINT(-65.50048 43.2532)",1982,1994,12,"13",12630
"POINT(-55.995809 46.034584)",1970,1994,24,"13",10680
"POINT(-63 47)",1971,2016,45,"46",10033
"POINT(-65.50048 43.2532)",1982,1994,12,"13",12027
"POINT(-67.064717 44.266029)",1980,1985,5,"3",11093
"POINT(-67.064717 44.266029)",1972,1994,22,"15",11124
"POINT(-63 47)",1972,2014,42,"19",10051
"POINT(-79.361398 43.62142)",2006,2012,6,"4",13516
"POINT(-77.072526 44.096244)",1992,2018,26,"27",13675
"POINT(-52.940252 44.204538)",1996,2009,13,"13",14846
"POINT(-61.87121 45.68314)",2004,2010,6,"7",15606
"POINT(-56.383301 46.711721)",1972,1982,10,"11",14896
"POINT(-63.728047 47.637685)",1984,1994,10,"7",10887
"POINT(-63.427139 46.193528)",2008,2010,2,"3",15092
"POINT(-53.864595 53.910492)",1970,1977,7,"3",10754
"POINT(-84.499722 49.25)",1995,2006,11,"12",9987
"POINT(-86 50)",1970,2014,44,"45",12826
"POINT(-69 43)",1967,1989,22,"23",13250
"POINT(-57.736944 49.689167)",1997,2007,10,"11",12999
"POINT(-52.782383 44.683779)",1970,1994,24,"11",10720
"POINT(-62.11238 46.383134)",2004,2010,6,"7",15605
"POINT(-77.72313 43.99472)",2008,2015,7,"2",13811
"POINT(-65.029957 47.777114)",2004,2010,6,"7",15599
"POINT(-65.50048 43.2532)",1982,1994,12,"13",11528
"POINT(-65.098835 42.729563)",1975,1990,15,"14",10853
"POINT(-65.63232 43.2452)",1980,2008,28,"29",14205
"POINT(-65.50048 43.2532)",1999,2013,14,"3",11712
"POINT(-59.853639 59.286076)",1978,1991,13,"6",10545
"POINT(-64.951922 46.75123)",2004,2010,6,"7",15761
"POINT(-61.455567 46.07815)",2004,2010,6,"7",15411
"POINT(-56.422124 48.62557)",1960,2013,53,"54",15842
"POINT(-71.16693 42.70009)",1982,2018,36,"37",15828
"POINT(-52.782383 44.683779)",1976,1991,15,"4",10559
"POINT(-63 47)",1971,2016,45,"46",10065
"POINT(-85.85278 41.72556)",1991,1995,4,"5",13119
"POINT(-67.86528 44.36722)",1968,1998,30,"26",9946
"POINT(-71.71751 46.41901)",2016,2019,3,"2",16042
"POINT(-61.56738 44.19795)",1982,1993,11,"12",11359
"POINT(-52.782383 44.683779)",1970,1993,23,"23",10593
"POINT(-72.82857 45.04889)",2016,2019,3,"2",15876
"POINT(-77.547686 43.947746)",1992,2012,20,"21",13509
"POINT(-79.361398 43.62142)",2006,2012,6,"4",13474
"POINT(-72.88129 46.69751)",2019,2021,2,"3",16147
"POINT(-67.5 40.4)",1955,1987,32,"33",13257
"POINT(-84.499722 49.25)",1995,2004,9,"9",9989
"POINT(-61.181309 42.866877)",1970,1994,24,"25",10568
"POINT(-64.126831 46.773778)",2011,2014,3,"2",15809
"POINT(-67.5 40.4)",1955,1987,32,"33",13152
"POINT(-72.47958 46.88236)",2016,2021,5,"2",15898
"POINT(-52.150931 52.188158)",1995,2004,9,"10",13123
"POINT(-63.06152 46.75491)",1970,2011,41,"42",14257
"POINT(-65.50048 43.2532)",1995,2014,19,"17",12083
"POINT(-63.06152 46.75491)",1978,2018,40,"41",14746
"POINT(-52.08333 49.08333)",1978,2009,31,"32",11224
"POINT(-63.802767 46.136433)",2005,2010,5,"3",15144
"POINT(-69.764352 44.157878)",1977,2000,23,"8",15868
"POINT(-77.229936 44.152886)",1992,2018,26,"27",13654
"POINT(-57.690888 43.437611)",1980,1992,12,"5",10226
"POINT(-77.229936 44.152886)",1992,2018,26,"27",13658
"POINT(-78.5 45.58333)",1977,1988,11,"12",10124
"POINT(-63.758716 46.383956)",2007,2010,3,"4",15760
"POINT(-50.370609 48.414273)",1977,2000,23,"24",14243
"POINT(-64.573724 46.34102)",2007,2008,1,"2",15458
"POINT(-65.50048 43.2532)",1995,2016,21,"22",12366
"POINT(-65.50048 43.2532)",1970,1981,11,"12",11696
"POINT(-84.499722 49.25)",1995,2005,10,"11",9988
"POINT(-49.956886 45.114711)",1970,1994,24,"20",10960
"POINT(-74.381869 45.160229)",1998,2016,18,"5",14014
"POINT(-61.56738 44.19795)",1970,1981,11,"12",12048
"POINT(-65.50048 43.2532)",1995,2016,21,"12",12292
"POINT(-49.956886 45.114711)",1970,1994,24,"16",10464
"POINT(-62.11238 46.383134)",2004,2010,6,"5",15804
"POINT(-79.361398 43.62142)",2006,2012,6,"4",13451
"POINT(-61.56738 44.19795)",1970,1981,11,"12",12082
"POINT(-64.554866 46.218937)",2004,2010,6,"7",15400
"POINT(-61.56738 44.19795)",1970,1981,11,"12",12327
"POINT(-65.50048 43.2532)",1995,2016,21,"20",12611
"POINT(-61.56738 44.19795)",1970,1981,11,"12",11771
"POINT(-65.63232 43.2452)",1970,2002,32,"33",14160
"POINT(-58.452138 49.69674)",1971,1994,23,"22",10460
"POINT(-64.861867 46.665292)",2006,2010,4,"5",15519
"POINT(-72.82857 45.04889)",2019,2021,2,"2",16144
"POINT(-61.56738 44.19795)",1995,2016,21,"19",12080
"POINT(-72.88129 46.69751)",2016,2021,5,"6",16032
"POINT(-61.56738 44.19795)",1970,1981,11,"12",11351
"POINT(-64.657552 47.746584)",2004,2010,6,"7",15763
"POINT(-61.87121 45.68314)",2004,2010,6,"6",15725
"POINT(-63.394728 46.363106)",2001,2002,1,"2",15855
"POINT(-49.931212 51.171824)",1983,2011,28,"29",14309
"POINT(-72 54)",1970,2014,44,"45",12776
"POINT(-53.864595 53.910492)",1970,1993,23,"23",10596
"POINT(-61.56738 44.19795)",2002,2016,14,"13",11915
"POINT(-52.757812 52.054271)",1995,2009,14,"15",14859
"POINT(-71.71751 46.41901)",2018,2021,3,"4",16240
"POINT(-69.041914 40.95268)",1984,2016,32,"33",14447
"POINT(-63 47)",1971,2016,45,"46",10006
"POINT(-74.381869 45.160229)",1984,2014,30,"6",14043
"POINT(-49.956886 45.114711)",1970,1994,24,"20",10927
"POINT(-65.50048 43.2532)",1990,1994,4,"2",11685
"POINT(-52.782383 44.683779)",1975,1984,9,"7",11102
"POINT(-49.956886 45.114711)",1970,1994,24,"25",10837
"POINT(-86 50)",1970,2014,44,"45",12687
"POINT(-82.517801 41.970728)",2002,2003,1,"2",15026
"POINT(-61.56738 44.19795)",1982,1994,12,"13",12365
"POINT(-65.50048 43.2532)",1982,1994,12,"13",11428
"POINT(-64.126831 46.773778)",2005,2010,5,"4",15061
"POINT(-68.615921 41.275324)",1950,2016,66,"67",14460
"POINT(-66.11667 46.55)",1970,2014,44,"45",12667
"POINT(-59 44.1)",1976,1990,14,"15",13258
"POINT(-79.146454 46.634905)",2002,2004,2,"3",10099
"POINT(-66.11572 44.8247)",1997,2012,15,"16",14801
"POINT(-63 47)",1978,1990,12,"13",13373
"POINT(-62.067902 49.652037)",1973,1994,21,"20",10678
"POINT(-49.956886 45.114711)",1970,1994,24,"25",10611
"POINT(-77.547686 43.947746)",1992,2012,20,"21",13484
"POINT(-79.85068 43.28331)",2006,2015,9,"6",13798
"POINT(-56.766309 56.477534)",1978,1988,10,"6",10993
"POINT(-72.47958 46.88236)",2016,2021,5,"2",15944
"POINT(-84.499722 49.25)",1995,2005,10,"11",9977
"POINT(-65.50048 43.2532)",1970,1981,11,"12",11689
"POINT(-64.11454 46.1827)",2009,2010,1,"2",15724
"POINT(-61.87121 45.68314)",2004,2008,4,"5",15052
"POINT(-74.58861 36.44722)",1985,2014,29,"30",14688
"POINT(-65.50048 43.2532)",1986,1988,2,"2",11450
"POINT(-56.766309 56.477534)",1978,1988,10,"5",10365
"POINT(-53.864595 53.910492)",1971,1994,23,"23",10562
"POINT(-72.47958 46.88236)",2016,2021,5,"2",16236
"POINT(-61.56738 44.19795)",1995,2016,21,"22",11990
"POINT(-71.71751 46.41901)",2017,2020,3,"2",15879
"POINT(-65.63232 43.2452)",1970,2002,32,"33",14185
"POINT(-61.017433 46.6243)",2008,2010,2,"3",15416
"POINT(-63.902612 46.237205)",2001,2006,5,"6",10072
"POINT(-53.37158 51.46769)",1979,2011,32,"33",14777
"POINT(-77.229936 44.152886)",1992,2018,26,"27",13649
"POINT(-65.50048 43.2532)",2001,2015,14,"4",12548
"POINT(-74.381869 45.160229)",1984,2018,34,"17",13697
"POINT(-71.71751 46.41901)",2016,2021,5,"4",15896
"POINT(-64.861867 46.665292)",2007,2010,3,"3",15686
"POINT(-68.526458 40.575228)",1964,2016,52,"53",14462
"POINT(-65.50048 43.2532)",1995,2016,21,"22",11938
"POINT(-63.06152 46.75491)",1978,2018,40,"41",14775
"POINT(-63.2 42)",1973,1986,13,"14",13371
"POINT(-69.555988 48.077602)",1994,1997,3,"4",14818
"POINT(-61.56738 44.19795)",1982,1994,12,"13",11735
"POINT(-61.56738 44.19795)",1995,2016,21,"22",12319
"POINT(-66.11572 44.8247)",1997,2012,15,"16",14493
"POINT(-55.995809 46.034584)",1982,1994,12,"3",10368
"POINT(-72.82857 45.04889)",2016,2021,5,"3",15928
"POINT(-63 45)",1970,2014,44,"45",12783
"POINT(-68.615921 41.275324)",1950,2016,66,"67",14656
"POINT(-65.63232 43.2452)",1980,2008,28,"29",14130
"POINT(-65.63232 43.2452)",1970,2002,32,"33",14260
"POINT(-61.455567 46.07815)",2011,2014,3,"2",15378
"POINT(-52.121122 50.695322)",1970,1993,23,"22",10595
"POINT(-63.2 42)",1973,1986,13,"14",13202
"POINT(-61.181309 42.866877)",1970,1994,24,"25",10139
"POINT(-61.56738 44.19795)",1970,1981,11,"9",12321
"POINT(-59.348941 46.441917)",1970,1994,24,"25",11072
"POINT(-65.50048 43.2532)",1970,1981,11,"12",11615
"POINT(-64.56477 46.273319)",2007,2010,3,"4",15076
"POINT(-55.995809 46.034584)",1970,1994,24,"24",10653
"POINT(-65.3 43)",1970,1997,27,"28",13323
"POINT(-61.56738 44.19795)",1970,1981,11,"9",11787
"POINT(-60.79843 53.003392)",1974,2014,40,"41",12883
"POINT(-74.58861 36.44722)",1985,2014,29,"30",14520
"POINT(-77.22225 44.149251)",2001,2015,14,"14",13867
"POINT(-74.381869 45.160229)",2000,2016,16,"5",14044
"POINT(-50.370609 48.414273)",1977,2000,23,"24",14193
"POINT(-61.56738 44.19795)",1995,2016,21,"22",11642
"POINT(-69.041914 40.95268)",1967,2014,47,"48",14673
"POINT(-61.56738 44.19795)",1982,1994,12,"13",11322
"POINT(-85.58 49.24)",1981,1984,3,"4",15823
"POINT(-57.771263 49.761184)",1971,2011,40,"41",11297
"POINT(-50.3 44.3)",1965,1986,21,"22",13326
"POINT(-61.455567 46.07815)",2004,2010,6,"7",15062
"POINT(-77.229936 44.152886)",1992,2018,26,"27",13713
"POINT(-63.758716 46.383956)",2011,2014,3,"2",15661
"POINT(-63.802767 46.136433)",2005,2010,5,"6",15341
"POINT(-84.499722 49.25)",1995,2006,11,"12",9981
"POINT(-53.864595 53.910492)",1973,1988,15,"14",10902
"POINT(-58.02978 50.13466)",1973,2003,30,"31",14317
"POINT(-57.690888 43.437611)",1991,1993,2,"3",10893
"POINT(-50.75978 47.607599)",1970,1994,24,"25",10134
"POINT(-61.56738 44.19795)",1995,2016,21,"22",12139
"POINT(-61.56738 44.19795)",1970,1978,8,"3",11868
"POINT(-61.56738 44.19795)",1988,1994,6,"3",12134
"POINT(-72 40)",1973,2016,43,"44",14725
"POINT(-71.71751 46.41901)",2016,2021,5,"6",15930
"POINT(-77.229936 44.152886)",1992,2018,26,"27",13765
"POINT(-65.098835 42.729563)",1970,1994,24,"25",10865
"POINT(-77.229936 44.152886)",1992,2012,20,"21",13530
"POINT(-57.690888 43.437611)",1970,1994,24,"25",10204
"POINT(-65.50048 43.2532)",1970,1981,11,"12",11348
"POINT(-65.50048 43.2532)",2011,2013,2,"2",12551
"POINT(-85.58269 49.249515)",1981,1984,3,"4",15821
"POINT(-65.029957 47.777114)",2004,2009,5,"4",15048
"POINT(-53.864595 53.910492)",1977,1991,14,"11",10839
"POINT(-57.05 51)",1971,1995,24,"25",13253
"POINT(-55.995809 46.034584)",1980,1992,12,"5",10636
"POINT(-63.06152 46.75491)",1970,2011,41,"42",14207
"POINT(-61.56738 44.19795)",1970,1981,11,"12",12463
"POINT(-65.62222 47.65259)",2009,2010,1,"2",15100
"POINT(-61.56738 44.19795)",1995,2016,21,"22",12036
"POINT(-59.853639 59.286076)",1978,1991,13,"5",10290
"POINT(-82.690547 42.436529)",1968,1984,16,"17",13109
"POINT(-63.758716 46.383956)",2011,2014,3,"2",15179
"POINT(-79.361398 43.62142)",2006,2012,6,"4",13549
"POINT(-82.517801 41.970728)",2002,2003,1,"2",15000
"POINT(-57.41455 46.93526)",1983,2011,28,"28",14383
"POINT(-64.56477 46.273319)",2007,2010,3,"4",15516
"POINT(-64.710486 46.475972)",2004,2010,6,"7",15653
"POINT(-61.56738 44.19795)",1971,1974,3,"2",12566
"POINT(-53.864595 53.910492)",1970,1994,24,"24",10543
"POINT(-84.673047 43.391047)",1999,2015,16,"17",14825
"POINT(-63.802767 46.136433)",2005,2010,5,"6",15228
"POINT(-52.782383 44.683779)",1970,1994,24,"13",10787
"POINT(-58.635512 47.364248)",1977,1994,17,"6",10762
"POINT(-65.562778 46.995278)",2004,2010,6,"4",15796
"POINT(-61.56738 44.19795)",1970,1981,11,"12",11702
"POINT(-50.521046 49.772834)",1975,2006,31,"32",14422
"POINT(-79.37806 44.73333)",1980,1987,7,"8",13423
"POINT(-71.093778 40.671798)",1989,2016,27,"28",14713
"POINT(-71.093778 40.671798)",1968,2006,38,"39",14327
"POINT(-61.56738 44.19795)",2011,2015,4,"2",11509
"POINT(-79.361398 43.62142)",2006,2012,6,"4",13453
"POINT(-85.893055 48.248123)",1972,1997,25,"21",15836
"POINT(-64.710486 46.475972)",2007,2010,3,"4",15461
"POINT(-65.50048 43.2532)",1970,1980,10,"8",12613
"POINT(-53.864595 53.910492)",1970,1994,24,"24",10260
"POINT(-61.56738 44.19795)",1970,1981,11,"12",11660
"POINT(-65.50048 43.2532)",1970,1981,11,"12",11623
"POINT(-61.164851 45.857738)",1996,1997,1,"2",14087
"POINT(-73.354865 46.481708)",1985,1997,12,"12",13070
"POINT(-79.361398 43.62142)",2006,2012,6,"4",13529
"POINT(-64.657552 47.746584)",2011,2014,3,"2",15611
"POINT(-68.615921 41.275324)",1950,2016,66,"67",14488
"POINT(-63.66575 45.8547)",2011,2014,3,"2",15358
"POINT(-65.50048 43.2532)",1982,1994,12,"8",11924
"POINT(-68.615921 41.275324)",1963,2016,53,"54",14540
"POINT(-61.56738 44.19795)",1982,1994,12,"13",11424
"POINT(-77.22225 44.149251)",2001,2015,14,"14",13805
"POINT(-68.615921 41.275324)",1963,2005,42,"43",14372
"POINT(-64.554866 46.218937)",2011,2014,3,"2",15287
"POINT(-85.58269 49.249515)",1981,1984,3,"4",15816
"POINT(-61.56738 44.19795)",1995,2016,21,"20",11476
"POINT(-65.50048 43.2532)",1995,2016,21,"21",12451
"POINT(-61.56738 44.19795)",1995,2016,21,"18",11387
"POINT(-65.50048 43.2532)",1970,1981,11,"12",11587
"POINT(-65.562778 46.995278)",2004,2010,6,"6",15484
"POINT(-72.82857 45.04889)",2016,2019,3,"2",16221
"POINT(-49.956886 45.114711)",1973,1989,16,"4",10710
"POINT(-71.753435 43.955654)",2012,2018,6,"5",13092
"POINT(-64.873712 47.473463)",2005,2007,2,"2",15710
"POINT(-72 40)",1973,2016,43,"44",14613
"POINT(-62.067902 49.652037)",1974,1989,15,"12",10359
"POINT(-58.452138 49.69674)",1985,1994,9,"6",10862
"POINT(-64.657552 47.746584)",2008,2010,2,"2",15047
"POINT(-61.56738 44.19795)",1997,2016,19,"13",11327
"POINT(-66.5073 43.7658)",1992,1993,1,"2",14985
"POINT(-48.319336 48.138699)",1975,1982,7,"8",14882
"POINT(-58.452138 49.69674)",1984,1994,10,"11",11100
"POINT(-63 47)",1981,2015,34,"19",10009
"POINT(-77.072526 44.096244)",1992,2012,20,"21",13506
"POINT(-61.181309 42.866877)",1971,1993,22,"16",10455
"POINT(-52.782383 44.683779)",1970,1994,24,"5",11113
"POINT(-57.690888 43.437611)",1970,1994,24,"25",11071
"POINT(-72 54)",1970,2014,44,"45",12760
"POINT(-61.181309 42.866877)",1973,1994,21,"9",10552
"POINT(-72.82857 45.04889)",2016,2021,5,"3",16204
"POINT(-59 49.25)",1965,2017,52,"53",14555
"POINT(-84.52551 50.219196)",2016,2017,1,"2",14995
"POINT(-74.018383 39.10066)",1975,2005,30,"31",14295
"POINT(-61 47)",1967,2010,43,"42",11270
"POINT(-65.25 44.333333)",1996,1997,1,"2",14051
"POINT(-65.50048 43.2532)",1998,2009,11,"7",12573
"POINT(-72.82857 45.04889)",2016,2021,5,"3",15935
"POINT(-57.690888 43.437611)",1970,1994,24,"20",10456
"POINT(-72 54)",1970,2014,44,"45",12662
"POINT(-47.89333 50.44083)",1983,2018,35,"36",14140
"POINT(-62.735984 45.290147)",1970,2014,44,"45",12701
"POINT(-72.88129 46.69751)",2016,2021,5,"2",16157
"POINT(-68.526458 40.575228)",1964,2016,52,"53",14798
"POINT(-53.864595 53.910492)",1971,1990,19,"7",10443
"POINT(-63.728047 47.637685)",1970,1994,24,"25",10136
"POINT(-68.615921 41.275324)",1963,2005,42,"43",14148
"POINT(-85.09167 55.26611)",1971,1972,1,"2",14826
"POINT(-61.56738 44.19795)",1984,1992,8,"7",12444
"POINT(-53.864595 53.910492)",1973,1993,20,"14",10972
"POINT(-61.56738 44.19795)",1982,1994,12,"13",12483
"POINT(-65.50048 43.2532)",1995,2016,21,"22",11999
"POINT(-58.635512 47.364248)",1971,1994,23,"23",10256
"POINT(-52 50)",1962,1992,30,"31",13420
"POINT(-62.067902 49.652037)",1985,1989,4,"3",10299
"POINT(-79.85068 43.28331)",2006,2010,4,"2",13890
"POINT(-49.956886 45.114711)",1970,1993,23,"24",10594
"POINT(-51 49.15)",1980,1996,16,"17",13199
"POINT(-61.56738 44.19795)",1970,1981,11,"9",11918
"POINT(-62.735984 45.290147)",1970,2012,42,"43",12752
"POINT(-79.361398 43.62142)",2006,2012,6,"4",13582
"POINT(-67.064717 44.266029)",1971,1994,23,"21",10842
"POINT(-61.56738 44.19795)",1970,1981,11,"12",12419
"POINT(-65.50048 43.2532)",1982,1994,12,"13",11421
"POINT(-57.690888 43.437611)",1982,1987,5,"5",11025
"POINT(-65.50048 43.2532)",1982,1988,6,"5",12584
"POINT(-64.573724 46.34102)",2011,2014,3,"2",15617
"POINT(-78.56511 67.35631)",2010,2011,1,"2",12989
"POINT(-63.728047 47.637685)",1971,1994,23,"15",10296
"POINT(-63.06152 46.75491)",1978,2018,40,"41",14719
"POINT(-65.50048 43.2532)",1995,2016,21,"22",12392
"POINT(-84.499722 49.25)",1995,2006,11,"12",9961
"POINT(-69 43)",1967,1989,22,"23",13230
"POINT(-65.50048 43.2532)",1983,1991,8,"6",12312
"POINT(-76.06 44.055)",1994,2001,7,"3",13051
"POINT(-50 43.083333)",1997,2011,14,"15",13446
"POINT(-65.50048 43.2532)",1995,2016,21,"21",11352
"POINT(-61.56738 44.19795)",1982,1994,12,"13",12081
"POINT(-48.33984 44.59046)",1977,2000,23,"24",14362
"POINT(-70.169007 47.453657)",1997,2004,7,"8",15833
"POINT(-58.452138 49.69674)",1970,1994,24,"24",10407
"POINT(-52.782383 44.683779)",1983,1994,11,"12",10483
"POINT(-56.383301 46.711721)",1972,1982,10,"11",14920
"POINT(-65.50048 43.2532)",1970,1981,11,"10",12276
"POINT(-61.56738 44.19795)",1982,1994,12,"13",12502
"POINT(-65.098835 42.729563)",1970,1994,24,"25",10140
"POINT(-72 54)",1970,2014,44,"45",12660
"POINT(-61.181309 42.866877)",1989,1992,3,"4",10892
"POINT(-57.854 44.91813)",1970,2002,32,"33",14281
"POINT(-53.183333 49.75)",2000,2003,3,"3",11178
"POINT(-61.56738 44.19795)",1997,2016,19,"13",12128
"POINT(-61.56738 44.19795)",1982,1994,12,"13",11366
"POINT(-63.728047 47.637685)",1980,1994,14,"11",10571
"POINT(-59 49.25)",1965,2017,52,"53",14443
"POINT(-76.629839 38.366022)",1984,2000,16,"17",14828
"POINT(-65.50048 43.2532)",1982,1994,12,"13",11722
"POINT(-61.56738 44.19795)",1970,1981,11,"8",11584
"POINT(-71.71751 46.41901)",2017,2021,4,"2",16087
"POINT(-77.22225 44.149251)",2001,2015,14,"14",13860
"POINT(-64.951922 46.75123)",2011,2014,3,"2",15274
"POINT(-71.093778 40.671798)",1989,2016,27,"28",14741
"POINT(-71.71751 46.41901)",2016,2021,5,"6",16237
"POINT(-71.093778 40.671798)",1967,2005,38,"39",14275
"POINT(-50.3 44.3)",1965,1986,21,"22",13284
"POINT(-68.526458 40.575228)",1982,2016,34,"35",14703
"POINT(-61.56738 44.19795)",1995,2016,21,"22",12257
"POINT(-79.361398 43.62142)",2006,2012,6,"4",13553
"POINT(-77.59299 44.01301)",2001,2015,14,"3",13774
"POINT(-86 50)",1970,2014,44,"45",12659
"POINT(-72.168755 47.006447)",1983,1997,14,"14",13068
"POINT(-56.383301 46.711721)",1996,2008,12,"5",14915
"POINT(-64.646046 47.789535)",2004,2010,6,"7",15412
"POINT(-71.093778 40.671798)",1968,2006,38,"39",14152
"POINT(-63.758716 46.383956)",2011,2014,3,"2",15730
"POINT(-70.87637 46.85767)",2019,2021,2,"3",15988
"POINT(-51 49.15)",1980,1996,16,"17",13283
"POINT(-61.56738 44.19795)",1995,2016,21,"22",12215
"POINT(-77.22225 44.149251)",2001,2015,14,"14",13899
"POINT(-72.82857 45.04889)",2016,2021,5,"3",16167
"POINT(-61.56738 44.19795)",1970,1981,11,"12",11497
"POINT(-65.50048 43.2532)",1970,1981,11,"12",12262
"POINT(-65.50048 43.2532)",1982,1994,12,"13",12508
"POINT(-82.517801 41.970728)",2002,2003,1,"2",15004
"POINT(-59.853639 59.286076)",1978,1988,10,"5",10581
"POINT(-65.25 44.333333)",1996,1997,1,"2",14059
"POINT(-61.56738 44.19795)",1986,1988,2,"2",11749
"POINT(-65.50048 43.2532)",1995,2016,21,"12",12025
"POINT(-65.50048 43.2532)",1970,1981,11,"12",12242
"POINT(-69.041914 40.95268)",1984,2016,32,"33",14615
"POINT(-79.361398 43.62142)",2006,2012,6,"4",13498
"POINT(-61.56738 44.19795)",1995,2016,21,"22",12417
"POINT(-72 54)",1970,2014,44,"45",12780
"POINT(-62.11238 46.383134)",2005,2010,5,"3",15774
"POINT(-86 50)",1970,2014,44,"45",12862
"POINT(-59.348941 46.441917)",1970,1994,24,"25",10534
"POINT(-61.56738 44.19795)",1970,1981,11,"12",11857
"POINT(-68.3 43.3)",2007,2014,7,"8",14498
"POINT(-61.56738 44.19795)",1988,1994,6,"3",12401
"POINT(-61.25 45.75)",1996,1997,1,"2",14066
"POINT(-59.853639 59.286076)",1979,1988,9,"3",11039
"POINT(-76.06 44.055)",1976,2015,39,"40",13039
"POINT(-57.41455 46.93526)",1983,2011,28,"28",14358
"POINT(-79.361398 43.62142)",2006,2012,6,"4",13551
"POINT(-77.072526 44.096244)",1992,2018,26,"27",13612
"POINT(-56.766309 56.477534)",1978,1987,9,"3",11038
"POINT(-61.56738 44.19795)",1982,1994,12,"13",12369
"POINT(-77.229936 44.152886)",1992,2018,26,"27",13723
"POINT(-63.802767 46.136433)",2005,2010,5,"6",15651
"POINT(-61.56738 44.19795)",1982,1994,12,"13",12326
"POINT(-61.181309 42.866877)",1982,1987,5,"5",10998
"POINT(-82.517801 41.970728)",2002,2003,1,"2",15036
"POINT(-72.82857 45.04889)",2016,2021,5,"2",15881
"POINT(-71.093778 40.671798)",1989,2016,27,"28",14461
"POINT(-70.87637 46.85767)",2018,2019,1,"2",16195
"POINT(-79.361398 43.62142)",2006,2012,6,"4",13524
"POINT(-78.291582 43.944964)",1974,1985,11,"9",13539
"POINT(-65.50048 43.2532)",1970,1981,11,"10",11742
"POINT(-86 50)",1970,2014,44,"45",12828
"POINT(-74.381869 45.160229)",1984,2018,34,"10",13971
"POINT(-65.50048 43.2532)",1996,2016,20,"12",11652
"POINT(-61.56738 44.19795)",1995,2016,21,"22",11349
"POINT(-63.728047 47.637685)",1970,1994,24,"25",10143
"POINT(-55.995809 46.034584)",1976,1994,18,"8",11026
"POINT(-79.361398 43.62142)",2006,2012,6,"4",13475
"POINT(-61.56738 44.19795)",1995,2016,21,"20",11743
"POINT(-61.56738 44.19795)",1985,1994,9,"8",12506
"POINT(-63.902612 46.237205)",2001,2003,2,"3",10091
"POINT(-86 50)",1970,2014,44,"45",12771
"POINT(-75.363333 35.224444)",1992,1993,1,"2",12651
"POINT(-60.3 44.1)",1967,1990,23,"24",13291
"POINT(-65.50048 43.2532)",1982,1994,12,"12",12568
"POINT(-65.50048 43.2532)",1970,1981,11,"11",11343
"POINT(-65.50048 43.2532)",1996,2016,20,"15",12517
"POINT(-53.864595 53.910492)",1981,1993,12,"5",11008
"POINT(-65.50048 43.2532)",1970,1981,11,"12",12394
"POINT(-66.214847 41.627502)",1986,1993,7,"8",10399
"POINT(-49.956886 45.114711)",1970,1993,23,"17",10788
"POINT(-77.229936 44.152886)",1992,2018,26,"27",13708
"POINT(-65.098835 42.729563)",1970,1994,24,"25",10401
"POINT(-62.74132 45.67583)",2004,2006,2,"2",15547
"POINT(-62.11238 46.383134)",2004,2010,6,"6",15655
"POINT(-65.098835 42.729563)",1971,1990,19,"9",10793
"POINT(-60.79843 53.003392)",1979,2014,35,"36",12807
"POINT(-65.029957 47.777114)",2011,2014,3,"2",15191
"POINT(-61.87121 45.68314)",2004,2010,6,"4",15492
"POINT(-82.517801 41.970728)",2002,2003,1,"2",15010
"POINT(-67.86528 44.36722)",1968,1998,30,"26",9942
"POINT(-63 47)",1972,2016,44,"36",10045
"POINT(-63.902612 46.237205)",2001,2006,5,"6",10087
"POINT(-65.50048 43.2532)",1970,1980,10,"8",12079
"POINT(-86 50)",1970,2014,44,"45",12782
"POINT(-61.181309 42.866877)",1974,1987,13,"5",11030
"POINT(-82.517801 41.970728)",2002,2003,1,"2",15018
"POINT(-59.348941 46.441917)",1971,1994,23,"24",10616
"POINT(-67.064717 44.266029)",1972,1993,21,"9",10247
"POINT(-69 43)",1967,1989,22,"23",13397
"POINT(-72.82857 45.04889)",2016,2019,3,"2",16181
"POINT(-58.452138 49.69674)",1972,1994,22,"18",10664
"POINT(-61.56738 44.19795)",1997,2016,19,"13",12395
"POINT(-64.657552 47.746584)",2004,2009,5,"4",15560
"POINT(-74.381869 45.160229)",1984,2018,34,"10",13950
"POINT(-50.16083 50.74444)",1978,1999,21,"22",11191
"POINT(-77.59299 44.01301)",2001,2015,14,"3",13779
"POINT(-63.06152 46.75491)",1978,2018,40,"41",14522
"POINT(-77.547686 43.947746)",1992,2018,26,"27",13630
"POINT(-68.615921 41.275324)",1963,2005,42,"43",14197
"POINT(-65.098835 42.729563)",1970,1994,24,"6",10884
"POINT(-69.041914 40.95268)",1969,2008,39,"40",14476
"POINT(-56.766309 56.477534)",1979,1988,9,"3",10704
"POINT(-61.56738 44.19795)",2002,2016,14,"13",12182
"POINT(-77.229936 44.152886)",1992,2018,26,"27",13920
"POINT(-65.50048 43.2532)",1970,1981,11,"12",12356
"POINT(-68.615921 41.275324)",1963,2016,53,"54",14792
"POINT(-62.4353 54.17529)",1980,2016,36,"10",12744
"POINT(-61.181309 42.866877)",1974,1994,20,"16",10497
"POINT(-65.50048 43.2532)",1995,2016,21,"22",12409
"POINT(-61.56738 44.19795)",1986,1988,2,"2",12016
"POINT(-74.381869 45.160229)",1998,2010,12,"2",13934
"POINT(-79.85068 43.28331)",2006,2015,9,"6",13868
"POINT(-79.317526 43.011112)",1999,2009,10,"11",15869
"POINT(-64.8083 47.67109)",2009,2010,1,"2",15137
"POINT(-72.82857 45.04889)",2016,2021,5,"2",16230
"POINT(-61.87121 45.68314)",2011,2014,3,"2",15149
"POINT(-61.56738 44.19795)",1982,1994,12,"13",11443
"POINT(-61.181309 42.866877)",1984,1994,10,"7",10476
"POINT(-61.56738 44.19795)",1982,1994,12,"9",11744
"POINT(-74.381869 45.160229)",1988,2014,26,"3",14021
"POINT(-69 43)",1967,1989,22,"23",13376
"POINT(-70.87637 46.85767)",2018,2021,3,"4",16049
"POINT(-63.446958 46.46855)",2011,2014,3,"2",15806
"POINT(-79.361398 43.62142)",2006,2012,6,"4",13532
"POINT(-61.017433 46.6243)",2008,2010,2,"3",15489
"POINT(-61.56738 44.19795)",1995,2016,21,"22",11996
"POINT(-74.018383 39.10066)",1968,2011,43,"44",14734
"POINT(-61.56738 44.19795)",1970,1981,11,"12",12259
"POINT(-62.28626 46.36766)",2011,2014,3,"2",15240
"POINT(-61.56738 44.19795)",1977,1981,4,"2",11330
"POINT(-51.3 44.3)",1968,1986,18,"19",13235
"POINT(-65.090012 44.451082)",1996,1997,1,"2",14076
"POINT(-65.50048 43.2532)",1995,2016,21,"22",11454
"POINT(-54.2 46.833333)",1980,2006,26,"24",14806
"POINT(-65.50048 43.2532)",1995,2016,21,"22",11888
"POINT(-74.381869 45.160229)",1994,2018,24,"4",13995
"POINT(-61.56738 44.19795)",1995,2016,21,"22",12106
"POINT(-65.63232 43.2452)",1980,2008,28,"29",14405
"POINT(-63 45)",1970,2012,42,"43",12748
"POINT(-72 54)",1970,2014,44,"45",12680
"POINT(-63.2 42)",1973,1986,13,"14",13287
"POINT(-65.50048 43.2532)",1995,2016,21,"22",12040
"POINT(-64.657552 47.746584)",2005,2008,3,"4",15449
"POINT(-65.50048 43.2532)",1996,2015,19,"10",11598
"POINT(-61.56738 44.19795)",1996,2016,20,"14",11863
"POINT(-53.864595 53.910492)",1970,1994,24,"23",10790
"POINT(-52.782383 44.683779)",1970,1994,24,"17",11020
"POINT(-65.50048 43.2532)",1982,1994,12,"13",11881
"POINT(-55.995809 46.034584)",1976,1985,9,"3",10418
"POINT(-68.615921 41.275324)",1950,2016,66,"67",14796
"POINT(-79.85068 43.28331)",2006,2014,8,"5",13812
"POINT(-72.82857 45.04889)",2016,2021,5,"3",15895
"POINT(-68.615921 41.275324)",1963,2009,46,"47",14513
"POINT(-68.615921 41.275324)",1963,2009,46,"47",14681
"POINT(-63.2 42)",1973,1986,13,"14",13350
"POINT(-61.56738 44.19795)",1995,2016,21,"22",11817
"POINT(-63 47)",1980,2016,36,"32",10038
"POINT(-61.896111 47.392778)",1972,2005,33,"27",14112
"POINT(-57.93333 48.95)",1994,1997,3,"4",13103
"POINT(-63 47)",1971,2016,45,"46",10046
"POINT(-49.956886 45.114711)",1971,1993,22,"16",10577
"POINT(-65.50048 43.2532)",2001,2014,13,"7",11391
"POINT(-53.864595 53.910492)",1974,1994,20,"12",10371
"POINT(-63.802767 46.136433)",2011,2014,3,"2",15193
"POINT(-71.093778 40.671798)",1967,2005,38,"39",14400
"POINT(-61.56738 44.19795)",1995,2016,21,"22",12530
"POINT(-59.12841 47.47266)",1974,2010,36,"37",14552
"POINT(-65.50048 43.2532)",1982,1988,6,"5",11783
"POINT(-65.63232 43.2452)",1970,2010,40,"41",14236
"POINT(-65.50048 43.2532)",1995,2016,21,"22",11561
"POINT(-61.017433 46.6243)",2011,2014,3,"2",15303
"POINT(-65.029957 47.777114)",2004,2010,6,"7",15226
"POINT(-66.089296 44.42804)",1999,2006,7,"8",11143
"POINT(-61.56738 44.19795)",1982,1994,12,"13",11831
"POINT(-65.098835 42.729563)",1972,1984,12,"6",10840
"POINT(-63.802767 46.136433)",2011,2014,3,"2",15621
"POINT(-65.57426 46.98624)",2008,2010,2,"3",15142
"POINT(-64.56477 46.273319)",2007,2010,3,"3",15450
"POINT(-68.615921 41.275324)",1950,2007,57,"58",14627
"POINT(-59.348941 46.441917)",1972,1993,21,"10",10691
"POINT(-79.361398 43.62142)",2006,2012,6,"4",13556
"POINT(-65.57426 46.98624)",2008,2010,2,"3",15457
"POINT(-61.56738 44.19795)",1995,2016,21,"10",11541
"POINT(-86 50)",1970,2014,44,"45",12854
"POINT(-68.871657 43.27657)",1982,2014,32,"33",14455
"POINT(-74.018383 39.10066)",1973,2002,29,"30",14246
"POINT(-77.22225 44.149251)",2001,2015,14,"13",13590
"POINT(-61.56738 44.19795)",1995,2016,21,"22",11755
"POINT(-64.573724 46.34102)",2011,2014,3,"2",15779
"POINT(-77.547686 43.947746)",1992,2012,20,"21",13455
"POINT(-79.361398 43.62142)",2006,2012,6,"4",13550
"POINT(-65.50048 43.2532)",1995,2016,21,"22",12033
"POINT(-82.517801 41.970728)",2002,2003,1,"2",15021
"POINT(-71.71751 46.41901)",2018,2020,2,"2",15970
"POINT(-82.517801 41.970728)",2002,2003,1,"2",15007
"POINT(-66.214847 41.627502)",1980,1993,13,"10",10667
"POINT(-63.126667 46.235)",1998,1999,1,"2",14980
"POINT(-61.56738 44.19795)",1995,2016,21,"22",11550
"POINT(-62.11238 46.383134)",2011,2014,3,"2",15754
"POINT(-86 50)",1970,2014,44,"45",12686
"POINT(-63.66575 45.8547)",2004,2010,6,"7",15324
"POINT(-73.43806 38.53306)",1963,2009,46,"47",14782
"POINT(-61.181309 42.866877)",1970,1994,24,"25",10168
"POINT(-53.864595 53.910492)",1973,1986,13,"6",10312
"POINT(-61.56738 44.19795)",1982,1994,12,"6",11840
"POINT(-57.854 44.91813)",1970,2002,32,"33",14306
"POINT(-61.56738 44.19795)",1995,2016,21,"22",12586
"POINT(-63 47)",1971,2016,45,"43",10052
"POINT(-62.067902 49.652037)",1973,1993,20,"18",10618
"POINT(-78.5 45.58333)",1976,1989,13,"14",10119
"POINT(-65.098835 42.729563)",1985,1987,2,"3",11031
"POINT(-65.50048 43.2532)",1970,1981,11,"12",12591
"POINT(-61.56738 44.19795)",1982,1994,12,"13",11489
"POINT(-84.499722 49.25)",1995,2006,11,"12",9976
"POINT(-72 54)",1970,2014,44,"45",12863
"POINT(-56.766309 56.477534)",1977,1991,14,"9",10261
"POINT(-59 44.1)",1976,1990,14,"15",13405
"POINT(-66.291594 46.666605)",1970,2014,44,"45",12721
"POINT(-86 50)",1970,2014,44,"45",12848
"POINT(-65.50048 43.2532)",1995,2016,21,"22",11459
"POINT(-55.225157 50.548819)",1969,2010,41,"15",12967
"POINT(-52.757812 52.054271)",1977,1994,17,"18",14960
"POINT(-74.381869 45.160229)",1984,2014,30,"6",14022
"POINT(-53.864595 53.910492)",1970,1994,24,"24",10214
"POINT(-61.56738 44.19795)",1970,1981,11,"12",11825
"POINT(-63 43)",1965,2006,41,"42",11230
"POINT(-74.018383 39.10066)",1982,2015,33,"34",14509
"POINT(-59.348941 46.441917)",1976,1992,16,"4",10357
"POINT(-65.098835 42.729563)",1970,1994,24,"25",10161
"POINT(-65.50048 43.2532)",1970,1981,11,"12",12490
"POINT(-57.690888 43.437611)",1970,1994,24,"25",10877
"POINT(-79.361398 43.62142)",2006,2012,6,"4",13531
"POINT(-79.361398 43.62142)",2006,2012,6,"4",13573
"POINT(-65.3 43)",1970,1997,27,"28",13281
"POINT(-63 47)",1974,2015,41,"34",10032
"POINT(-68.871657 43.27657)",1982,2014,32,"33",14791
"POINT(-48.319336 48.138699)",1975,1982,7,"8",14906
"POINT(-62.44628 43.89789)",1974,2008,34,"35",14213
"POINT(-50.457342 50.936521)",1995,2009,14,"15",14850
"POINT(-68.871657 43.27657)",1982,2014,32,"33",14707
"POINT(-77.547686 43.947746)",1992,2018,26,"27",13689
"POINT(-62.44628 43.89789)",1974,2008,34,"35",14188
"POINT(-59.601847 46.402344)",1981,2005,24,"25",11227
"POINT(-61.56738 44.19795)",1995,2016,21,"22",11582
"POINT(-67.064717 44.266029)",1971,1994,23,"19",10201
"POINT(-59.348941 46.441917)",1973,1994,21,"16",11014
"POINT(-74.381869 45.160229)",2000,2016,16,"5",14023
"POINT(-63.2 42)",1973,1986,13,"14",13224
"POINT(-64.56477 46.273319)",2007,2010,3,"4",15106
"POINT(-73.107078 52.941847)",1970,2014,44,"45",12809
"POINT(-68.615921 41.275324)",1970,2016,46,"47",14710
"POINT(-53.864595 53.910492)",1970,1994,24,"24",10184
"POINT(-76.794435 44.062208)",1992,2012,20,"21",13562
"POINT(-77.72313 43.99472)",2008,2015,7,"2",13858
"POINT(-63 47)",1971,2016,45,"45",10029
"POINT(-65.50048 43.2532)",1995,2016,21,"19",12044
"POINT(-61.56738 44.19795)",1998,2009,11,"3",12375
"POINT(-79.37806 44.73333)",1980,1987,7,"8",13255
"POINT(-61.56738 44.19795)",1995,2016,21,"22",11872
"POINT(-72.47958 46.88236)",2016,2021,5,"2",16152
"POINT(-65.50048 43.2532)",1970,1981,11,"12",11399
"POINT(-65.50048 43.2532)",1982,1994,12,"13",11688
"POINT(-65.3 43)",1962,1988,26,"27",13366
"POINT(-78.432602 45.029279)",1995,2006,11,"12",11158
"POINT(-77.72313 43.99472)",2008,2015,7,"2",13887
"POINT(-63.06152 46.75491)",1978,2018,40,"41",14662
"POINT(-53.864595 53.910492)",1973,1994,21,"21",10328
"POINT(-62.11238 46.383134)",2011,2014,3,"2",15508
"POINT(-61.56738 44.19795)",1970,1981,11,"12",11929
"POINT(-77.396957 43.50608)",1997,2018,21,"22",13968
"POINT(-65.50048 43.2532)",1996,2016,20,"12",11576
"POINT(-84.267975 45.465968)",1975,1997,22,"2",9995
"POINT(-68.615921 41.275324)",1970,2016,46,"47",14570
"POINT(-77.396957 43.50608)",2011,2018,7,"8",15046
"POINT(-61.56738 44.19795)",1995,2016,21,"22",12524
"POINT(-63.902612 46.237205)",2001,2003,2,"3",10085
"POINT(-52.121122 50.695322)",1973,1993,20,"16",10721
"POINT(-78.523333 45.595278)",1952,1995,43,"43",12948
"POINT(-52.121122 50.695322)",1978,1990,12,"3",11028
"POINT(-63.728047 47.637685)",1970,1993,23,"13",11089
"POINT(-61.56738 44.19795)",1989,1993,4,"2",11409
"POINT(-65.50048 43.2532)",1970,1981,11,"12",11555
"POINT(-84.499722 49.25)",1995,2005,10,"11",9954
"POINT(-74.381869 45.160229)",1994,2018,24,"4",13953
"POINT(-79.87 45.25)",1995,2002,7,"6",13121
"POINT(-61.56738 44.19795)",1970,1981,11,"12",12003
"POINT(-55.3 46)",1959,1993,34,"35",13243
"POINT(-77.22225 44.149251)",2001,2015,14,"14",13593
"POINT(-63.446958 46.46855)",2004,2010,6,"7",15581
"POINT(-55.995809 46.034584)",1977,1994,17,"12",10665
"POINT(-63 47)",1978,1990,12,"13",13141
"POINT(-86 50)",1970,2014,44,"45",12836
"POINT(-59.853639 59.286076)",1978,1991,13,"6",10792
"POINT(-82.41083 42.56111)",2002,2003,1,"2",13112
"POINT(-73.107078 52.941847)",1970,2014,44,"45",12712
"POINT(-52.782383 44.683779)",1970,1981,11,"5",11027
"POINT(-77.229936 44.152886)",1992,2018,26,"27",13983
"POINT(-71.093778 40.671798)",1989,2016,27,"28",14517
"POINT(-65.562778 46.995278)",2011,2014,3,"2",15740
"POINT(-64.710486 46.475972)",2011,2014,3,"2",15196
"POINT(-77.59299 44.01301)",2001,2015,14,"3",13834
"POINT(-65.098835 42.729563)",1974,1994,20,"11",11087
"POINT(-56.383301 46.711721)",1984,1995,11,"12",14941
"POINT(-50.521046 49.772834)",1975,2006,31,"32",14702
"POINT(-71.16693 42.70009)",1983,2018,35,"36",15829
"POINT(-58.452138 49.69674)",1983,1994,11,"9",10799
"POINT(-61.017433 46.6243)",2008,2010,2,"2",15534
"POINT(-63.421546 46.34346)",2009,2011,2,"3",12932
"POINT(-62.067902 49.652037)",1972,1994,22,"22",10253
"POINT(-53.864595 53.910492)",1978,1994,16,"6",10376
"POINT(-72.82857 45.04889)",2016,2021,5,"3",16023
"POINT(-63.2 42)",1973,1986,13,"14",13266
"POINT(-77.80861 43.698439)",1997,2012,15,"15",13541
"POINT(-59.609137 49.495564)",1987,2010,23,"24",11272
"POINT(-50 43.083333)",2002,2011,9,"10",13439
"POINT(-56.383301 46.711721)",1984,1993,9,"5",14964
"POINT(-65.50048 43.2532)",1970,1981,11,"12",11429
"POINT(-61.56738 44.19795)",1970,1981,11,"12",11950
"POINT(-64.710486 46.475972)",2004,2010,6,"7",15343
"POINT(-66.214847 41.627502)",1984,1993,9,"7",11116
"POINT(-76.794435 44.062208)",1992,2018,26,"27",13682
"POINT(-69.041914 40.95268)",1969,2008,39,"40",14532
"POINT(-64.951922 46.75123)",2011,2014,3,"2",15159
"POINT(-72.82857 45.04889)",2016,2021,5,"3",15892
"POINT(-65.50048 43.2532)",1970,1981,11,"12",11680
"POINT(-59 44.1)",1976,1990,14,"15",13300
"POINT(-59 49.25)",1965,2017,52,"53",14724
"POINT(-82.517801 41.970728)",2002,2003,1,"2",15025
"POINT(-66.75 46.5)",1970,2014,44,"45",12831
"POINT(-79.85068 43.28331)",2006,2015,9,"6",13855
"POINT(-64.710486 46.475972)",2011,2014,3,"2",15156
"POINT(-59 50)",1985,2003,18,"19",11225
"POINT(-77.072526 44.096244)",1992,2018,26,"27",13614
"POINT(-61.56738 44.19795)",1982,1994,12,"13",12030
"POINT(-84.52551 50.219196)",2016,2017,1,"2",14993
"POINT(-64.8083 47.67109)",2011,2014,3,"2",15276
"POINT(-68.615921 41.275324)",1963,2016,53,"54",14456
"POINT(-74.381869 45.160229)",2002,2016,14,"3",13970
"POINT(-61.56738 44.19795)",1970,1978,8,"3",12402
"POINT(-68.871657 43.27657)",1985,2016,31,"32",14603
"POINT(-71.71751 46.41901)",2018,2020,2,"3",15914
"POINT(-63.728047 47.637685)",1984,1990,6,"3",10235
"POINT(-55.995809 46.034584)",1975,1994,19,"15",10393
"POINT(-70.42472 47.26306)",1994,2000,6,"7",15827
"POINT(-61.56738 44.19795)",1983,1993,10,"8",11519
"POINT(-58.452138 49.69674)",1970,1994,24,"24",10537
"POINT(-59.348941 46.441917)",1970,1994,24,"25",10908
"POINT(-61.56738 44.19795)",1995,2016,21,"22",11934
"POINT(-74.018383 39.10066)",1968,2011,43,"44",14762
"POINT(-49.956886 45.114711)",1970,1994,24,"21",10764
"POINT(-61.56738 44.19795)",1995,2016,21,"21",12070
"POINT(-64.710486 46.475972)",2005,2008,3,"2",15708
"POINT(-65.50048 43.2532)",1982,1994,12,"13",11853
"POINT(-59.12841 47.47266)",1974,2010,36,"37",14636
"POINT(-72 54)",1970,2014,44,"45",12762
"POINT(-68.871657 43.27657)",1982,2014,32,"33",14427
"POINT(-61.56738 44.19795)",1970,1981,11,"12",12600
"POINT(-61.56738 44.19795)",1982,1994,12,"6",11426
"POINT(-63 47)",1974,2016,42,"39",10048
"POINT(-65.50048 43.2532)",1995,2016,21,"22",12422
"POINT(-61.56738 44.19795)",1970,1981,11,"10",12435
"POINT(-69.555988 48.077602)",1994,1997,3,"4",14819
"POINT(-52.121122 50.695322)",1970,1994,24,"24",10151
"POINT(-61.56738 44.19795)",1972,1981,9,"6",12606
"POINT(-64.861867 46.665292)",2011,2014,3,"2",15467
"POINT(-61.56738 44.19795)",1995,2016,21,"22",12046
"POINT(-72.82857 45.04889)",2019,2021,2,"2",15975
"POINT(-51.3 44.3)",1968,1986,18,"19",13382
"POINT(-65.50048 43.2532)",1983,1994,11,"4",11646
"POINT(-61.56738 44.19795)",1982,1994,12,"13",12140
"POINT(-50.370609 48.414273)",1977,2000,23,"24",14168
"POINT(-56.383301 46.711721)",1996,2010,14,"14",14866
"POINT(-81.74926 45.1588)",2002,2006,4,"5",13105
"POINT(-64.965766 47.341712)",2004,2010,6,"5",15628
"POINT(-61.56738 44.19795)",1982,1994,12,"13",11792
"POINT(-65.50048 43.2532)",1970,1981,11,"6",11517
"POINT(-65.50048 43.2532)",1982,1994,12,"13",11534
"POINT(-71.71751 46.41901)",2016,2021,5,"5",16176
"POINT(-62.067902 49.652037)",1978,1993,15,"12",10716
"POINT(-55.995809 46.034584)",1980,1994,14,"6",10983
"POINT(-63.728047 47.637685)",1970,1993,23,"24",10588
"POINT(-72.88129 46.69751)",2016,2021,5,"6",15897
"POINT(-78.291582 43.944964)",1974,1985,11,"9",13512
"POINT(-63.394728 46.363106)",2001,2002,1,"2",15854
"POINT(-65.50048 43.2532)",1982,1994,12,"13",11586
"POINT(-65.50048 43.2532)",1995,2016,21,"17",12171
"POINT(-62.74132 45.67583)",2004,2010,6,"7",15214
"POINT(-62.067902 49.652037)",1983,1994,11,"12",10880
"POINT(-61.56738 44.19795)",1982,1994,12,"13",12332
"POINT(-53.864595 53.910492)",1973,1993,20,"5",10430
"POINT(-79.85068 43.28331)",2006,2015,9,"6",13802
"POINT(-65.50048 43.2532)",1970,1981,11,"12",12149
"POINT(-58.635512 47.364248)",1984,1988,4,"5",11112
"POINT(-64.951922 46.75123)",2011,2014,3,"2",15439
"POINT(-55.995809 46.034584)",1987,1994,7,"6",10500
"POINT(-61.56738 44.19795)",1971,1974,3,"2",12299
"POINT(-61.56738 44.19795)",1984,1993,9,"4",12413
"POINT(-72.47958 46.88236)",2016,2021,5,"2",16126
"POINT(-65.50048 43.2532)",1995,2016,21,"22",11608
"POINT(-63.06152 46.75491)",1978,2018,40,"41",14495
"POINT(-59.853639 59.286076)",1979,1988,9,"4",10974
"POINT(-61.56738 44.19795)",1970,1981,11,"8",11851
"POINT(-61.56738 44.19795)",1970,1981,11,"12",11930
"POINT(-52.782383 44.683779)",1979,1994,15,"7",11035
"POINT(-64.657552 47.746584)",2011,2014,3,"2",15664
"POINT(-63.446958 46.46855)",2004,2010,6,"7",15509
"POINT(-61.56738 44.19795)",1986,1988,2,"2",12550
"POINT(-61.56738 44.19795)",1995,2016,21,"22",11524
"POINT(-79.361398 43.62142)",2006,2012,6,"4",13515
"POINT(-79.361398 43.62142)",2006,2012,6,"4",13545
"POINT(-85.58 49.24)",1981,1984,3,"4",15818
"POINT(-64.8083 47.67109)",2011,2014,3,"2",15669
"POINT(-52.782383 44.683779)",1970,1994,24,"20",10874
"POINT(-59 44.1)",1976,1990,14,"15",13342
"POINT(-79.087009 46.416229)",2002,2004,2,"3",10109
"POINT(-79.85068 43.28331)",2006,2015,9,"3",13869
"POINT(-63.188167 45.760967)",2011,2014,3,"2",15349
"POINT(-59.348941 46.441917)",1970,1994,24,"15",10280
"POINT(-58.74 49.68361)",1987,2011,24,"25",11204
"POINT(-61.87121 45.68314)",2004,2010,6,"7",15699
"POINT(-76.06 44.055)",1978,1990,12,"3",13041
"POINT(-79.361398 43.62142)",2006,2012,6,"4",13518
"POINT(-63.126667 46.235)",1998,1999,1,"2",14976
"POINT(-75.363333 35.224444)",1992,1993,1,"2",12726
"POINT(-72 40)",1973,2016,43,"44",14781
"POINT(-62.067902 49.652037)",1973,1994,21,"8",10546
"POINT(-47.89333 50.44083)",1983,2018,35,"36",14315
"POINT(-57.690888 43.437611)",1982,1994,12,"12",10320
"POINT(-63.126667 46.235)",1998,1999,1,"2",14982
"POINT(-61.56738 44.19795)",1970,1981,11,"12",11410
"POINT(-77 57.83333)",1964,1979,15,"16",10117
"POINT(-66.214847 41.627502)",1980,1993,13,"10",10657
"POINT(-59.348941 46.441917)",1970,1994,24,"12",10673
"POINT(-64.861867 46.665292)",2006,2010,4,"5",15109
"POINT(-64.8083 47.67109)",2011,2014,3,"2",15290
"POINT(-50 43.083333)",2002,2011,9,"10",13432
"POINT(-68.615921 41.275324)",1963,2005,42,"43",14249
"POINT(-65.50048 43.2532)",1982,1994,12,"13",12423
"POINT(-61.56738 44.19795)",1995,2016,21,"20",12308
"POINT(-77.229936 44.152886)",1992,2018,26,"27",13707
"POINT(-61.56738 44.19795)",2010,2014,4,"2",12430
"POINT(-71.71751 46.41901)",2016,2021,5,"6",16025
"POINT(-68.615921 41.275324)",1963,2005,42,"43",14224
"POINT(-69.041914 40.95268)",1984,2016,32,"33",14475
"POINT(-52.757812 52.054271)",1977,1994,17,"18",14862
"POINT(-65.50048 43.2532)",1970,1981,11,"12",11666
"POINT(-49.922537 47.393967)",1965,2012,47,"48",13426
"POINT(-65.50048 43.2532)",1982,1994,12,"13",11592
"POINT(-71.71751 46.41901)",2016,2021,5,"2",15915
"POINT(-61.181309 42.866877)",1982,1987,5,"4",10949
"POINT(-48.33984 44.59046)",1977,2000,23,"24",14287
"POINT(-57.690888 43.437611)",1970,1994,24,"21",11060
"POINT(-62.28626 46.36766)",2011,2014,3,"2",15353
"POINT(-65.733333 43.466667)",1983,2017,34,"5",14109
"POINT(-52.757812 52.054271)",1995,2009,14,"15",14907
"POINT(-79.96722 45.04694)",1975,1976,1,"2",13107
"POINT(-77.547686 43.947746)",1992,2018,26,"27",13741
"POINT(-72.88129 46.69751)",2016,2021,5,"6",16130
"POINT(-52.782383 44.683779)",1973,1994,21,"16",10271
"POINT(-70.87637 46.85767)",2018,2020,2,"2",15984
"POINT(-63.888896 46.512101)",2009,2010,1,"2",15644
"POINT(-76.06 44.055)",1977,2015,38,"39",13049
"POINT(-64.8083 47.67109)",2009,2010,1,"2",15565
"POINT(-69.041914 40.95268)",1967,2014,47,"48",14785
"POINT(-57.690888 43.437611)",1973,1991,18,"4",10356
"POINT(-65.50048 43.2532)",1970,1981,11,"6",11784
"POINT(-77.59299 44.01301)",2001,2015,14,"3",13787
"POINT(-62.067902 49.652037)",1972,1994,22,"19",10807
"POINT(-65.50048 43.2532)",1984,1994,10,"10",11544
"POINT(-52 50)",1962,1992,30,"31",13378
"POINT(-64.573724 46.34102)",2007,2010,3,"4",15571
"POINT(-76.953595 45.785988)",1999,2000,1,"2",12994
"POINT(-65.50048 43.2532)",1970,1975,5,"4",11936
"POINT(-51 49.15)",1980,1996,16,"17",13136
"POINT(-61.181309 42.866877)",1970,1994,24,"23",10194
"POINT(-55.995809 46.034584)",1970,1994,24,"24",10749
"POINT(-68.615921 41.275324)",1970,2016,46,"47",14682
"POINT(-53.183333 49.75)",2000,2003,3,"3",11181
"POINT(-66.933194 45.009941)",1970,1978,8,"9",12966
"POINT(-65.3 43)",1970,1997,27,"28",13176
"POINT(-64.126831 46.773778)",2011,2014,3,"2",15741
"POINT(-77.547686 43.947746)",1992,2012,20,"21",13482
"POINT(-65.63232 43.2452)",1982,2006,24,"25",14316
"POINT(-81.610784 45.18731)",2004,2015,11,"12",12923
"POINT(-77.072526 44.096244)",1992,2018,26,"27",13921
"POINT(-61.56738 44.19795)",1982,1994,12,"13",12297
"POINT(-76.06 44.055)",1981,1991,10,"6",13057
"POINT(-64.573724 46.34102)",2011,2014,3,"2",15146
"POINT(-65.098835 42.729563)",1970,1994,24,"25",10827
"POINT(-77.072526 44.096244)",1992,2018,26,"27",13728
"POINT(-61.87121 45.68314)",2004,2010,6,"7",15233
"POINT(-65.50048 43.2532)",1970,1981,11,"12",12138
"POINT(-78.523333 45.595278)",1952,1995,43,"43",11278
"POINT(-65.63232 43.2452)",1970,2002,32,"33",14385
"POINT(-65.57426 46.98624)",2008,2010,2,"3",15335
"POINT(-63.739472 45.85055)",2005,2008,3,"2",15546
"POINT(-65.098835 42.729563)",1970,1994,24,"25",10190
"POINT(-65.50048 43.2532)",1970,1975,5,"4",12203
"POINT(-61.56738 44.19795)",1995,2016,21,"22",11834
"POINT(-68.615921 41.275324)",1963,2009,46,"47",14709
"POINT(-66.214847 41.627502)",1986,1991,5,"6",10413
"POINT(-76.794435 44.062208)",1992,2018,26,"27",13677
"POINT(-52.121122 50.695322)",1970,1994,24,"21",10915
"POINT(-62.28626 46.36766)",2011,2014,3,"2",15610
"POINT(-61.455567 46.07815)",2011,2014,3,"2",15713
"POINT(-86 50)",1970,2014,44,"45",12856
"POINT(-67.064717 44.266029)",1973,1994,21,"7",10802
"POINT(-65.57426 46.98624)",2008,2010,2,"3",15595
"POINT(-74.931907 47.16858)",1972,2012,40,"32",11302
"POINT(-79.85068 43.28331)",2006,2014,8,"6",13851
"POINT(-65.50048 43.2532)",2000,2015,15,"14",12382
"POINT(-63.739472 45.85055)",2005,2009,4,"5",15635
"POINT(-61.56738 44.19795)",1982,1994,12,"13",11675
"POINT(-64.873712 47.473463)",2011,2014,3,"2",15658
"POINT(-68.615921 41.275324)",1963,2005,42,"43",14348
"POINT(-79.361398 43.62142)",2006,2012,6,"4",13534
"POINT(-72.47958 46.88236)",2016,2021,5,"2",15983
"POINT(-56.088564 46.878456)",1978,2001,23,"2",14814
"POINT(-81.87611 45.625)",1950,1983,33,"34",13191
"POINT(-66.214847 41.627502)",1984,1993,9,"9",11081
"POINT(-65.50048 43.2532)",2000,2015,15,"14",12115
"POINT(-65.50048 43.2532)",1985,1993,8,"2",12187
"POINT(-64.554866 46.218937)",2004,2010,6,"7",15765
"POINT(-63 47)",1972,2016,44,"43",10015
"POINT(-77.229936 44.152886)",1992,2018,26,"27",13602
"POINT(-61.56738 44.19795)",1983,1994,11,"11",12117
"POINT(-53.864595 53.910492)",1970,1994,24,"24",10243
"POINT(-63.06152 46.75491)",1970,2011,41,"42",14382
"POINT(-77.547686 43.947746)",1992,2018,26,"27",13685
"POINT(-61.017433 46.6243)",2008,2010,2,"3",15225
"POINT(-64.351142 48.893948)",1973,2008,35,"6",14110
"POINT(-56.33304 48.60645)",1980,2016,36,"37",12742
"POINT(-61.181309 42.866877)",1970,1994,24,"25",10166
"POINT(-73.93333 40.15)",1995,1999,4,"5",15863
"POINT(-51.946243 46.968577)",1972,2012,40,"41",13079
"POINT(-50.28156 53.257559)",1977,1994,17,"17",14836
"POINT(-58.452138 49.69674)",1984,1988,4,"5",11111
"POINT(-76.1975 43.02139)",1991,1994,3,"4",11175
"POINT(-61.56738 44.19795)",1982,1994,12,"13",12605
"POINT(-61.56738 44.19795)",1982,1994,12,"13",12636
"POINT(-73.107078 52.941847)",1970,2014,44,"45",12889
"POINT(-73.107078 52.941847)",1970,2014,44,"45",12703
"POINT(-79.146454 46.634905)",2002,2004,2,"3",10111
"POINT(-61.56738 44.19795)",1988,1994,6,"3",11867
"POINT(-67.064717 44.266029)",1982,1994,12,"4",10431
"POINT(-74.018383 39.10066)",1982,2015,33,"34",14677
"POINT(-68.91861 43.33056)",1967,1994,27,"28",12939
"POINT(-65.63232 43.2452)",1982,2006,24,"25",14166
"POINT(-57.690888 43.437611)",1982,1990,8,"4",10886
"POINT(-86 50)",1970,2014,44,"45",12675
"POINT(-81.10944 44.42389)",1992,1994,2,"3",13002
"POINT(-59 49.25)",1965,2017,52,"53",14528
"POINT(-61.56738 44.19795)",1995,2016,21,"22",11371
"POINT(-63.213505 46.253599)",2009,2011,2,"3",12931
"POINT(-59.853639 59.286076)",1978,1988,10,"5",10398
"POINT(-56.766309 56.477534)",1978,1988,10,"6",10580
"POINT(-70.87637 46.85767)",2016,2021,5,"6",15952
"POINT(-65.098835 42.729563)",1970,1994,24,"24",10658
"POINT(-63.2 42)",1973,1986,13,"14",13244
"POINT(-65.50048 43.2532)",1995,2016,21,"22",12240
"POINT(-61.56738 44.19795)",1982,1994,12,"13",12515
"POINT(-74.018383 39.10066)",1982,2015,33,"34",14649
"POINT(-61.455567 46.07815)",2011,2014,3,"2",15160
"POINT(-72.88129 46.69751)",2016,2019,3,"2",16229
"POINT(-65.50048 43.2532)",1995,2016,21,"22",12446
"POINT(-59.118548 49.64164)",1983,1986,3,"4",13028
"POINT(-60.310565 49.696327)",1990,2012,22,"23",11284
"POINT(-77.22225 44.149251)",2001,2015,14,"14",13850
"POINT(-62.74132 45.67583)",2011,2014,3,"2",15808
"POINT(-61.181309 42.866877)",1970,1994,24,"25",10771
"POINT(-61.56738 44.19795)",1970,1981,11,"12",11815
"POINT(-52.782383 44.683779)",1991,1994,3,"3",10369
"POINT(-50 43.083333)",2002,2011,9,"10",13436
"POINT(-84.499722 49.25)",1995,2006,11,"12",9967
"POINT(-74.381869 45.160229)",1998,2010,12,"2",13997
"POINT(-63.188167 45.760967)",2011,2014,3,"2",15186
"POINT(-64.657552 47.746584)",2011,2014,3,"2",15440
"POINT(-71.71751 46.41901)",2016,2021,5,"6",16168
"POINT(-74.018383 39.10066)",1971,2016,45,"46",14424
"POINT(-52.121122 50.695322)",1970,1994,24,"23",10684
"POINT(-61.181309 42.866877)",1971,1993,22,"20",10934
"POINT(-58.452138 49.69674)",1970,1993,23,"23",10590
"POINT(-63 47)",1985,2016,31,"26",10042
"POINT(-50.457342 50.936521)",1993,1994,1,"2",14843
"POINT(-65.3 43)",1962,1988,26,"27",13135
"POINT(-65.50048 43.2532)",1970,1981,11,"12",11529
"POINT(-62.067902 49.652037)",1972,1993,21,"21",10747
"POINT(-65.50048 43.2532)",1995,2016,21,"22",12228
"POINT(-65.562778 46.995278)",2004,2009,5,"6",15060
"POINT(-59 49.25)",1965,2017,52,"53",14499
"POINT(-72.88129 46.69751)",2016,2021,5,"5",16209
"POINT(-59.931111 43.934444)",1961,2010,49,"50",11266
"POINT(-74.018383 39.10066)",1975,2005,30,"31",14120
"POINT(-64.965766 47.341712)",2004,2010,6,"7",15511
"POINT(-52.782383 44.683779)",1982,1991,9,"3",10428
"POINT(-70.87637 46.85767)",2020,2021,1,"2",15921
"POINT(-61.56738 44.19795)",2011,2015,4,"2",11776
"POINT(-65.50048 43.2532)",1982,1994,12,"13",12137
"POINT(-76.06 44.055)",1980,2015,35,"23",13050
"POINT(-78.523333 45.595278)",1972,1991,19,"19",12958
"POINT(-61.181309 42.866877)",1973,1993,20,"16",10729
"POINT(-62.735984 45.290147)",1970,2014,44,"45",12880
"POINT(-65.50048 43.2532)",1985,2016,31,"7",12628
"POINT(-56.766309 56.477534)",1978,1986,8,"4",10346
"POINT(-63.446958 46.46855)",2011,2014,3,"2",15279
"POINT(-63 45)",1970,2014,44,"45",12839
"POINT(-58.635512 47.364248)",1971,1994,23,"16",10409
"POINT(-63.728047 47.637685)",1970,1994,24,"25",10509
"POINT(-74.95944 35.53583)",1972,2003,31,"32",13129
"POINT(-73.19 45.57)",1966,1976,10,"10",12979
"POINT(-65.50048 43.2532)",1995,2016,21,"22",11378
"POINT(-79.85068 43.28331)",2006,2015,9,"5",13836
"POINT(-81.10944 44.42389)",1992,1994,2,"3",13003
"POINT(-77.396957 43.50608)",1978,2018,40,"40",13945
"POINT(-64.573724 46.34102)",2011,2014,3,"2",15302
"POINT(-61.56738 44.19795)",1995,2016,21,"22",11423
"POINT(-61.56738 44.19795)",1995,2016,21,"22",11785
"POINT(-77.229936 44.152886)",1992,2018,26,"27",13657
"POINT(-61.56738 44.19795)",1982,1994,12,"13",11724
"POINT(-56.766309 56.477534)",1978,1988,10,"4",10973
"POINT(-61.56738 44.19795)",1982,1994,12,"13",12225
"POINT(-65.562778 46.995278)",2004,2010,6,"7",15525
"POINT(-72.47958 46.88236)",2016,2021,5,"2",16051
"POINT(-61.455567 46.07815)",2004,2009,5,"4",15567
"POINT(-65.50048 43.2532)",1995,2016,21,"22",11858
"POINT(-56.383301 46.711721)",1984,1991,7,"5",14966
"POINT(-63.2 42)",1973,1986,13,"14",13328
"POINT(-77.229936 44.152886)",1992,2018,26,"27",14025
"POINT(-61.56738 44.19795)",1995,2016,21,"22",12468
"POINT(-61.56738 44.19795)",1995,2016,21,"22",11556
"POINT(-72.88129 46.69751)",2016,2021,5,"4",15891
"POINT(-73.8975 41.15917)",1997,1999,2,"3",13122
"POINT(-72 40)",1973,2016,43,"44",14641
"POINT(-57.690888 43.437611)",1970,1983,13,"5",10447
"POINT(-50.3 44.3)",1965,1986,21,"22",13347
"POINT(-56.383301 46.711721)",1999,2010,11,"10",14937
"POINT(-62.623787 44.8325)",1960,2010,50,"51",11263
"POINT(-70.877222 42.8125)",1964,2009,45,"46",12993
"POINT(-70.77 46.97)",1970,1998,28,"28",13113
"POINT(-60.3 44.1)",1967,1990,23,"24",13207
"POINT(-65.50048 43.2532)",1996,2016,20,"12",11385
"POINT(-63.728047 47.637685)",1972,1990,18,"7",10448
"POINT(-65.029957 47.777114)",2004,2010,6,"7",15649
"POINT(-72.88129 46.69751)",2016,2021,5,"6",16196
"POINT(-65.50048 43.2532)",1982,1994,12,"13",11431
"POINT(-62.28626 46.36766)",2011,2014,3,"2",15499
"POINT(-65.3 43)",1962,1988,26,"27",13345
"POINT(-64.861867 46.665292)",2008,2009,1,"2",15463
"POINT(-55.995809 46.034584)",1970,1994,24,"24",10183
"POINT(-61.181309 42.866877)",1970,1994,24,"19",10668
"POINT(-65.50048 43.2532)",1995,2016,21,"22",11671
"POINT(-77.22225 44.149251)",2001,2015,14,"14",13594
"POINT(-64.873712 47.473463)",2011,2014,3,"2",15494
"POINT(-58.635512 47.364248)",1973,1994,21,"20",10958
"POINT(-65.63232 43.2452)",1970,2010,40,"41",14286
"POINT(-82.5 42.166667)",1972,2002,30,"2",10132
"POINT(-71.71751 46.41901)",2016,2021,5,"6",16093
"POINT(-64.126831 46.773778)",2004,2010,6,"7",15409
"POINT(-65.098835 42.729563)",1979,1993,14,"6",10937
"POINT(-65.50048 43.2532)",1982,1994,12,"13",12561
"POINT(-48.319336 48.138699)",1975,1982,7,"8",14953
"POINT(-61.56738 44.19795)",1984,1992,8,"7",11376
"POINT(-61.164851 45.857738)",1995,1997,2,"3",14097
"POINT(-52.121122 50.695322)",1971,1994,23,"20",10698
"POINT(-65.50048 43.2532)",1982,1994,12,"13",11622
"POINT(-77.72313 43.99472)",2008,2015,7,"2",13792
"POINT(-68.871657 43.27657)",1985,2016,31,"32",14491
"POINT(-65.50048 43.2532)",1984,1994,10,"10",12078
"POINT(-76.874151 47.166578)",1983,1997,14,"14",13073
"POINT(-64.873712 47.473463)",2006,2010,4,"4",15682
"POINT(-77.396957 43.50608)",1978,2018,40,"40",13924
"POINT(-61.56738 44.19795)",1987,1990,3,"2",11986
"POINT(-65.50048 43.2532)",1995,2016,21,"22",11773
"POINT(-79.37806 44.73333)",1980,1987,7,"8",13234
"POINT(-68.615921 41.275324)",1963,2005,42,"43",14323
"POINT(-61.56738 44.19795)",1995,2016,21,"22",11985
"POINT(-65.50048 43.2532)",1996,2014,18,"4",12109
"POINT(-63 45)",1970,2014,44,"45",12683
"POINT(-76.06 44.055)",1983,1992,9,"2",13060
"POINT(-75.124448 37.831692)",1986,2010,24,"25",13020
"POINT(-56 52)",1971,2010,39,"40",11214
"POINT(-68.615921 41.275324)",1963,2005,42,"43",14124
"POINT(-55.3 46)",1959,1993,34,"35",13390
"POINT(-75.363333 35.224444)",1992,1993,1,"2",12724
"POINT(-65.50048 43.2532)",1982,1992,10,"6",11577
"POINT(-63.2 42)",1973,1986,13,"14",13140
"POINT(-62.74132 45.67583)",2011,2014,3,"2",15738
"POINT(-61.56738 44.19795)",1995,2016,21,"22",12097
"POINT(-79.087009 46.416229)",2002,2004,2,"3",10103
"POINT(-65.50048 43.2532)",1970,1981,11,"12",12021
"POINT(-61.56738 44.19795)",1995,2016,21,"22",12443
"POINT(-52 50)",1962,1992,30,"31",13189
"POINT(-61.455567 46.07815)",2004,2010,6,"7",15088
"POINT(-64.861867 46.665292)",2009,2010,1,"2",15772
"POINT(-86 50)",1970,2014,44,"45",12688
"POINT(-62.44628 43.89789)",1974,2008,34,"35",14238
"POINT(-67 41)",1950,1998,48,"49",13322
"POINT(-63 47)",1973,2016,43,"38",10018
"POINT(-61.56738 44.19795)",1997,2016,19,"20",12549
"POINT(-86 50)",1970,2014,44,"45",12694
"POINT(-61.56738 44.19795)",1972,1973,1,"2",11580
"POINT(-65.50048 43.2532)",1995,2016,21,"22",12260
"POINT(-61.181309 42.866877)",1970,1994,24,"25",10942
"POINT(-65.029957 47.777114)",2005,2010,5,"4",15801
"POINT(-72.47958 46.88236)",2016,2021,5,"2",16101
"POINT(-63.2 42)",1973,1986,13,"14",13391
"POINT(-68.91861 43.33056)",1967,1994,27,"28",12940
"POINT(-50 43.083333)",2002,2011,9,"10",13447
"POINT(-72.88129 46.69751)",2016,2019,3,"2",15948
"POINT(-66.214847 41.627502)",1984,1993,9,"9",10582
"POINT(-52 50)",1962,1992,30,"31",13231
"POINT(-59 44.1)",1976,1990,14,"15",13195
"POINT(-74.018383 39.10066)",1968,2011,43,"44",14678
"POINT(-64.951922 46.75123)",2011,2014,3,"2",15239
"POINT(-63.2 42)",1973,1986,13,"14",13182
"POINT(-63.728047 47.637685)",1985,1991,6,"3",10738
"POINT(-61.56738 44.19795)",1996,2016,20,"14",12397
"POINT(-83.05 42.033333)",1976,2004,28,"28",12912
"POINT(-64.56477 46.273319)",2011,2014,3,"2",15355
"POINT(-57.690888 43.437611)",1974,1994,20,"21",10675
"POINT(-62.11238 46.383134)",2011,2014,3,"2",15310
"POINT(-62.547863 46.172776)",2005,2010,5,"6",15420
"POINT(-73.107078 52.941847)",1970,2014,44,"45",12720
"POINT(-59.348941 46.441917)",1970,1994,24,"17",10472
"POINT(-63.728047 47.637685)",1970,1994,24,"25",10206
"POINT(-74.381869 45.160229)",2002,2016,14,"3",13928
"POINT(-68.871657 43.27657)",1982,2014,32,"33",14483
"POINT(-63.14804 46.23122)",2009,2010,1,"2",15413
"POINT(-55.995809 46.034584)",1970,1994,24,"24",10620
"POINT(-65.098835 42.729563)",1970,1994,24,"11",10445
"POINT(-61.181309 42.866877)",1970,1994,24,"23",10906
"POINT(-63.446958 46.46855)",2004,2010,6,"7",15783
"POINT(-77.547686 43.947746)",1992,2018,26,"27",13743
"POINT(-63.06152 46.75491)",1970,2011,41,"42",14407
"POINT(-65.50048 43.2532)",2011,2013,2,"2",11750
"POINT(-61.181309 42.866877)",1971,1992,21,"7",10671
"POINT(-77.072526 44.096244)",1992,2018,26,"27",13613
"POINT(-77.547686 43.947746)",1992,2018,26,"27",13626
"POINT(-61.56738 44.19795)",1970,1981,11,"12",11490
"POINT(-68.871657 43.27657)",1985,2016,31,"32",14575
"POINT(-72.88129 46.69751)",2016,2021,5,"6",15939
"POINT(-86 50)",1970,2014,44,"45",12798
"POINT(-53.37158 51.46769)",1979,2011,32,"33",14805
"POINT(-79.361398 43.62142)",2006,2012,6,"4",13469
"POINT(-48.33984 44.59046)",1977,2000,23,"24",14387
"POINT(-70.87637 46.85767)",2016,2019,3,"2",16183
"POINT(-68.871657 43.27657)",1985,2016,31,"32",14659
"POINT(-65.50048 43.2532)",1982,1994,12,"13",11801
"POINT(-58.452138 49.69674)",1972,1994,22,"12",11017
"POINT(-74.58861 36.44722)",1981,2008,27,"28",14178
"POINT(-72.88129 46.69751)",2016,2021,5,"5",15875
"POINT(-65.50048 43.2532)",1995,2016,21,"22",12307
"POINT(-65.50048 43.2532)",1995,2005,10,"2",11639
"POINT(-59.348941 46.441917)",1970,1994,24,"25",10251
"POINT(-56.383301 46.711721)",1996,2008,12,"5",14939
"POINT(-79.85068 43.28331)",2006,2015,9,"6",13808
"POINT(-74.018383 39.10066)",1968,2011,43,"44",14454
"POINT(-55.995809 46.034584)",1970,1994,24,"24",10512
"POINT(-70.87637 46.85767)",2017,2021,4,"3",16169
"POINT(-57.05 51)",1971,1995,24,"25",13211
"POINT(-78.523333 45.595278)",1952,1995,43,"43",12959
"POINT(-65.3 43)",1970,1997,27,"28",13197
"POINT(-74.58861 36.44722)",1981,2008,27,"28",14128
"POINT(-68.3 43.3)",2007,2014,7,"8",14638
"POINT(-61.181309 42.866877)",1970,1994,24,"25",10187
"POINT(-66 45)",1994,2012,18,"19",13015
"POINT(-79.85068 43.28331)",2006,2015,9,"6",13781
"POINT(-65.090012 44.451082)",1996,1997,1,"2",14062
"POINT(-65.098835 42.729563)",1970,1994,24,"20",10277
"POINT(-52 50)",1962,1992,30,"31",13210
"POINT(-66.214847 41.627502)",1984,1993,9,"6",10372
"POINT(-49.956886 45.114711)",1972,1994,22,"5",10560
"POINT(-61.56738 44.19795)",2011,2015,4,"2",12310
"POINT(-65.62222 47.65259)",2009,2010,1,"2",15231
"POINT(-70.87637 46.85767)",2019,2021,2,"3",16056
"POINT(-71.71751 46.41901)",2018,2019,1,"2",16089
"POINT(-60.79843 53.003392)",1974,2014,40,"41",12716
"POINT(-65.63232 43.2452)",1970,2007,37,"38",14329
"POINT(-62.11238 46.383134)",2004,2010,6,"7",15423
"POINT(-77.396957 43.50608)",1997,2018,21,"22",13969
"POINT(-72.47958 46.88236)",2016,2021,5,"2",16171
"POINT(-71.71751 46.41901)",2016,2021,5,"6",16109
"POINT(-52.757812 52.054271)",1995,2009,14,"15",14956
"POINT(-74.018383 39.10066)",1973,2002,29,"30",14271
"POINT(-65.50048 43.2532)",1995,2016,21,"22",12328
"POINT(-61.56738 44.19795)",1970,1981,11,"12",11548
"POINT(-74.018383 39.10066)",1968,2011,43,"44",14538
"POINT(-82.517801 41.970728)",2002,2003,1,"2",15005
"POINT(-77.547686 43.947746)",1992,2018,26,"27",13986
"POINT(-63.66575 45.8547)",2011,2014,3,"2",15777
"POINT(-50.3 44.3)",1965,1986,21,"22",13410
"POINT(-61.56738 44.19795)",1995,2016,21,"22",11605
"POINT(-65.098835 42.729563)",1979,1993,14,"6",10193
"POINT(-70.77 46.97)",1970,1998,28,"28",13114
"POINT(-61.56738 44.19795)",1970,1981,11,"12",11469
"POINT(-65.63232 43.2452)",1970,2002,32,"33",14135
"POINT(-61.56738 44.19795)",1998,2009,11,"3",12642
"POINT(-58.635512 47.364248)",1973,1994,21,"20",10325
"POINT(-58.635512 47.364248)",1987,1993,6,"3",10386
"POINT(-65.50048 43.2532)",1995,2016,21,"22",11800
"POINT(-61.71722 48.33722)",1978,2000,22,"23",11193
"POINT(-62.067902 49.652037)",1972,1994,22,"22",11055
"POINT(-75.348421 39.407679)",1961,2013,52,"53",11128
"POINT(-61.56738 44.19795)",1996,2008,12,"9",12133
"POINT(-63.2 42)",1973,1986,13,"14",13370
"POINT(-79.85068 43.28331)",2006,2015,9,"6",13793
"POINT(-58.452138 49.69674)",1979,1994,15,"5",10557
"POINT(-77.072526 44.096244)",1992,2018,26,"27",13942
"POINT(-61.56738 44.19795)",1995,2015,20,"12",11895
"POINT(-71.71751 46.41901)",2016,2021,5,"6",16054
"POINT(-79.85068 43.28331)",2006,2015,9,"6",13874
"POINT(-64.646046 47.789535)",2011,2014,3,"2",15744
"POINT(-85.58269 49.249515)",1981,1984,3,"4",15822
"POINT(-63 47)",1992,2016,24,"25",10037
"POINT(-65.50048 43.2532)",1995,2016,21,"22",12541
"POINT(-64.573724 46.34102)",2011,2014,3,"2",15189
"POINT(-55.995809 46.034584)",1970,1994,24,"22",10408
"POINT(-62.11238 46.383134)",2004,2010,6,"7",15541
"POINT(-61.181309 42.866877)",1982,1987,5,"3",10263
"POINT(-68.871657 43.27657)",1985,2016,31,"32",14715
"POINT(-71.093778 40.671798)",1982,2012,30,"31",14151
"POINT(-57.690888 43.437611)",1970,1994,24,"25",10845
"POINT(-71.736244 43.961609)",2012,2018,6,"5",13094
"POINT(-48.319336 48.138699)",1975,1982,7,"8",14928
"POINT(-63.739472 45.85055)",2005,2009,4,"4",15518
"POINT(-82.5 42.166667)",1972,2002,30,"2",10128
"POINT(-71.71751 46.41901)",2016,2021,5,"6",16201
"POINT(-65.63232 43.2452)",1982,2006,24,"25",14241
"POINT(-63 47)",1972,2016,44,"38",10061
"POINT(-64.554866 46.218937)",2004,2010,6,"7",15208
"POINT(-72.82857 45.04889)",2016,2021,5,"3",15919
"POINT(-72.47958 46.88236)",2016,2021,5,"2",15979
"POINT(-61.56738 44.19795)",1995,2016,21,"21",11751
"POINT(-81.87611 45.625)",1950,1983,33,"34",13233
"POINT(-61.1985 45.9668)",1996,1997,1,"2",14064
"POINT(-65.50048 43.2532)",1995,2016,21,"19",12311
"POINT(-61.455567 46.07815)",2004,2010,6,"6",15426
"POINT(-63.728047 47.637685)",1970,1994,24,"22",10281
"POINT(-72.88129 46.69751)",2016,2020,4,"2",16000
"POINT(-72.88129 46.69751)",2016,2021,5,"5",16037
"POINT(-77.547686 43.947746)",1992,2018,26,"27",13684
"POINT(-82 60)",1985,2001,16,"3",11157
"POINT(-71.71751 46.41901)",2017,2020,3,"3",16003
"POINT(-77.547686 43.947746)",1992,2018,26,"27",13742
"POINT(-77.396957 43.50608)",1997,2018,21,"22",13926
"POINT(-59.348941 46.441917)",1973,1994,21,"11",10731
"POINT(-59.348941 46.441917)",1971,1994,23,"4",10727
"POINT(-52.782383 44.683779)",1970,1994,24,"23",11078
"POINT(-55.995809 46.034584)",1970,1994,24,"13",10374
"POINT(-61.56738 44.19795)",1995,2016,21,"22",11321
"POINT(-82.517801 41.970728)",2002,2003,1,"2",15015
"POINT(-62.74132 45.67583)",2011,2014,3,"2",15671
"POINT(-72.82857 45.04889)",2016,2019,3,"2",16217
"POINT(-68.526458 40.575228)",1964,2016,52,"53",14490
"POINT(-64.646046 47.789535)",2004,2010,6,"3",15694
"POINT(-65.098835 42.729563)",1971,1994,23,"22",10876
"POINT(-71.71751 46.41901)",2016,2021,5,"6",15958
"POINT(-56.33304 48.60645)",1980,2016,36,"37",12739
"POINT(-65.029957 47.777114)",2005,2010,5,"4",15572
"POINT(-63 47)",1971,2016,45,"44",10010
"POINT(-58.452138 49.69674)",1984,1994,10,"7",10635
"POINT(-65.50048 43.2532)",1996,2014,18,"4",12376
"POINT(-61.56738 44.19795)",1995,2016,21,"22",12618
"POINT(-65.63232 43.2452)",1980,2008,28,"29",14380
"POINT(-63.728047 47.637685)",1974,1987,13,"3",10623
"POINT(-60.79843 53.003392)",1979,2014,35,"36",12707
"POINT(-61.87121 45.68314)",2004,2010,6,"3",15576
"POINT(-69.041914 40.95268)",1969,2008,39,"40",14560
"POINT(-52.782383 44.683779)",1973,1994,21,"18",10836
"POINT(-84.499722 49.25)",1995,2006,11,"12",9984
"POINT(-71.71751 46.41901)",2016,2021,5,"5",16232
"POINT(-62.28626 46.36766)",2008,2010,2,"3",15514
"POINT(-64.873712 47.473463)",2011,2014,3,"2",15185
"POINT(-77.229936 44.152886)",1992,2018,26,"27",13706
"POINT(-63.427139 46.193528)",2008,2010,2,"3",15415
"POINT(-76.793641 37.5234)",2013,2018,5,"6",13026
"POINT(-61.56738 44.19795)",1970,1981,11,"12",11514
"POINT(-62.547863 46.172776)",2005,2010,5,"6",15128
"POINT(-55.3 46)",1959,1993,34,"35",13138
"POINT(-63.06152 46.75491)",1978,2018,40,"41",14690
"POINT(-58.02978 50.13466)",1973,2003,30,"31",14117
"POINT(-76.06 44.055)",1977,2012,35,"16",13059
"POINT(-52.121122 50.695322)",1978,1993,15,"11",10638
"POINT(-76.06 44.055)",1981,2015,34,"16",13040
"POINT(-78.523333 45.595278)",1972,1991,19,"19",11274
"POINT(-71.71751 46.41901)",2016,2020,4,"3",16081
"POINT(-59 49.25)",1965,2017,52,"53",14611
"POINT(-57 46.06667)",1972,1995,23,"24",11209
"POINT(-69 43)",1967,1989,22,"23",13272
"POINT(-65.50048 43.2532)",1982,1994,12,"13",12480
"POINT(-71.71751 46.41901)",2016,2020,4,"3",16011
"POINT(-64.965766 47.341712)",2011,2014,3,"2",15237
"POINT(-59.853639 59.286076)",1978,1991,13,"6",10687
"POINT(-65.50048 43.2532)",1995,2016,21,"19",12578
"POINT(-61.56738 44.19795)",1987,1990,3,"2",12520
"POINT(-47.89333 50.44083)",1983,2018,35,"36",14190
"POINT(-63.07912 47.227308)",1985,2012,27,"27",11281
"POINT(-74.931907 47.16858)",1972,2012,40,"32",11294
"POINT(-72.82857 45.04889)",2016,2021,5,"3",16151
"POINT(-61.56738 44.19795)",1982,1994,12,"13",12469
"POINT(-65.50048 43.2532)",1995,2016,21,"22",11645
"POINT(-63.446958 46.46855)",2004,2010,6,"7",15268
"POINT(-73.93333 40.15)",1995,1999,4,"5",15862
"POINT(-62.28626 46.36766)",2008,2010,2,"3",15104
"POINT(-63 47)",1985,2016,31,"31",10027
"POINT(-62.74132 45.67583)",2004,2007,3,"3",15464
"POINT(-72.82857 45.04889)",2016,2021,5,"3",16028
"POINT(-71.093778 40.671798)",1982,2012,30,"31",14251
"POINT(-66.11667 46.55)",1970,2014,44,"45",12834
"POINT(-65.63232 43.2452)",1970,2010,40,"41",14161
"POINT(-56.766309 56.477534)",1978,1988,10,"6",10487
"POINT(-77.072526 44.096244)",1992,2018,26,"27",13731
"POINT(-61.56738 44.19795)",1982,1994,12,"13",11617
"POINT(-72.82857 45.04889)",2016,2021,5,"3",15913
"POINT(-61.56738 44.19795)",1982,1994,12,"13",12235
"POINT(-63.06152 46.75491)",1978,2018,40,"41",14718
"POINT(-61.56738 44.19795)",1982,1994,12,"13",11756
"POINT(-65.098835 42.729563)",1970,1994,24,"25",11125
"POINT(-74.018383 39.10066)",1973,2002,29,"30",14321
"POINT(-52.782383 44.683779)",1970,1993,23,"11",10285
"POINT(-78.28194 56.90167)",1985,2004,19,"2",11222
"POINT(-71.093778 40.671798)",1982,2012,30,"31",14301
"POINT(-71.093778 40.671798)",1982,2012,30,"31",14376
"POINT(-64.56477 46.273319)",2011,2014,3,"2",15733
"POINT(-73.107078 52.941847)",1970,2014,44,"45",12866
"POINT(-81.87611 45.625)",1950,1983,33,"34",13149
"POINT(-61.56738 44.19795)",1995,2016,21,"22",11779
"POINT(-65.50048 43.2532)",1982,1994,12,"13",11707
"POINT(-66.214847 41.627502)",1984,1992,8,"5",10496
"POINT(-65.098835 42.729563)",1970,1994,24,"25",10770
"POINT(-56.383301 46.711721)",1972,1982,10,"10",14873
"POINT(-64.646046 47.789535)",2004,2010,6,"7",15593
"POINT(-64.861867 46.665292)",2011,2014,3,"2",15369
"POINT(-77.229936 44.152886)",1992,2018,26,"27",13648
"POINT(-62.067902 49.652037)",1976,1992,16,"10",10832
"POINT(-47.89333 50.44083)",1983,2018,35,"36",14215
"POINT(-76.794435 44.062208)",1992,2012,20,"21",13535
"POINT(-65.50048 43.2532)",1995,2016,21,"22",11569
"POINT(-52 50)",1962,1992,30,"31",13336
"POINT(-77.072526 44.096244)",1992,2012,20,"21",13452
"POINT(-86 50)",1970,2014,44,"45",12825
"POINT(-62.067902 49.652037)",1978,1994,16,"16",10848
"POINT(-50.75978 47.607599)",1970,1994,24,"25",10175
"POINT(-67.064717 44.266029)",1971,1994,23,"21",11068
"POINT(-65.50048 43.2532)",1970,1981,11,"12",11337
"POINT(-52.121122 50.695322)",1976,1988,12,"3",11079
"POINT(-50.3 44.3)",1965,1986,21,"22",13179
"POINT(-64.126831 46.773778)",2005,2007,2,"2",15797
"POINT(-72.82857 45.04889)",2016,2021,5,"3",16064
"POINT(-66.291594 46.666605)",1970,2014,44,"45",12718
"POINT(-65.50048 43.2532)",1995,2016,21,"22",11591
"POINT(-64.11454 46.1827)",2009,2010,1,"2",15600
"POINT(-64.56477 46.273319)",2007,2010,3,"4",15320
"POINT(-65.50048 43.2532)",1970,1981,11,"12",11593
"POINT(-72 54)",1970,2014,44,"45",12864
"POINT(-64.657552 47.746584)",2004,2010,6,"7",15319
"POINT(-63.06152 46.75491)",1978,2018,40,"41",14747
"POINT(-74.381869 45.160229)",1984,2018,34,"16",13694
"POINT(-72.47958 46.88236)",2016,2021,5,"2",15929
"POINT(-65.50048 43.2532)",2001,2015,14,"4",12014
"POINT(-70.87637 46.85767)",2016,2017,1,"2",15874
"POINT(-61.56738 44.19795)",1982,1994,12,"13",12492
"POINT(-61.56738 44.19795)",1984,1994,10,"10",12169
"POINT(-62.067902 49.652037)",1972,1993,21,"21",10589
"POINT(-82.517801 41.970728)",2002,2003,1,"2",15032
"POINT(-50.521046 49.772834)",1975,2006,31,"32",14506
"POINT(-64.646046 47.789535)",2011,2014,3,"2",15379
"POINT(-64.11454 46.1827)",2009,2010,1,"2",15418
"POINT(-64.11454 46.1827)",2011,2014,3,"2",15384
"POINT(-57.690888 43.437611)",1970,1994,24,"24",11096
"POINT(-65.50048 43.2532)",1998,2009,11,"7",12039
"POINT(-61.56738 44.19795)",1972,1973,1,"2",12648
"POINT(-64.951922 46.75123)",2011,2014,3,"2",15775
"POINT(-57.690888 43.437611)",1970,1992,22,"19",10341
"POINT(-63.728047 47.637685)",1970,1994,24,"22",11098
"POINT(-69.666667 48.15)",1994,2005,11,"12",12913
"POINT(-71.093778 40.671798)",1982,2012,30,"31",14401
"POINT(-61.56738 44.19795)",1995,2016,21,"22",11734
"POINT(-72 54)",1970,2014,44,"45",12829
"POINT(-55.995809 46.034584)",1976,1994,18,"8",10342
"POINT(-63.2 42)",1973,1986,13,"14",13203
"POINT(-63 47)",1978,2010,32,"33",11232
"POINT(-66 45)",1999,2001,2,"3",10003
"POINT(-59.853639 59.286076)",1978,1988,10,"5",11051
"POINT(-60.3 44.1)",1967,1990,23,"24",13144
"POINT(-64.951922 46.75123)",2007,2010,3,"2",15771
"POINT(-74.381869 45.160229)",1984,2018,34,"17",13755
"POINT(-77.22225 44.149251)",2001,2015,14,"14",13784
"POINT(-65.50048 43.2532)",1982,1994,12,"13",11939
"POINT(-57.690888 43.437611)",1982,1987,5,"4",11033
"POINT(-63.06152 46.75491)",1978,2018,40,"41",14635
"POINT(-61.56738 44.19795)",1998,2006,8,"3",11978
"POINT(-55.995809 46.034584)",1970,1994,24,"24",10209
"POINT(-65.50048 43.2532)",1982,1994,12,"13",11347
"POINT(-56.383301 46.711721)",1972,1978,6,"7",14967
"POINT(-63.728047 47.637685)",1985,1994,9,"9",10889
"POINT(-61.56738 44.19795)",1995,2016,21,"22",11883
"POINT(-72.82857 45.04889)",2016,2021,5,"3",15905
"POINT(-83.05 42.033333)",1974,2004,30,"30",12909
"POINT(-55.3 46)",1959,1993,34,"35",13306
"POINT(-61.56738 44.19795)",1972,1973,1,"2",11847
"POINT(-63 47)",1978,1990,12,"13",13204
"POINT(-83.05 42.033333)",1976,2004,28,"28",12890
"POINT(-71.093778 40.671798)",1989,2016,27,"28",14769
"POINT(-65.50048 43.2532)",1982,1994,12,"13",12206
"POINT(-63.06152 46.75491)",1970,2011,41,"42",14182
"POINT(-61.87121 45.68314)",2004,2010,6,"5",15141
"POINT(-63.446958 46.46855)",2004,2010,6,"7",15312
"POINT(-50.28156 53.257559)",1995,2009,14,"15",14845
"POINT(-74.381869 45.160229)",1984,2018,34,"10",13929
"POINT(-62.44628 43.89789)",1974,2008,34,"35",14288
"POINT(-63 47)",1971,2016,45,"40",10028
"POINT(-74.58861 36.44722)",1981,2008,27,"28",14203
"POINT(-65.50048 43.2532)",1970,1981,11,"12",11699
"POINT(-57.690888 43.437611)",1978,1993,15,"10",10669
"POINT(-58.452138 49.69674)",1972,1994,22,"16",10833
"POINT(-65.25 44.333333)",1996,1997,1,"2",14099
"POINT(-65.029957 47.777114)",2005,2006,1,"2",15706
"POINT(-59.12841 47.47266)",1974,2010,36,"37",14748
"POINT(-57.690888 43.437611)",1972,1994,22,"16",10403
"POINT(-55.995809 46.034584)",1984,1994,10,"5",10882
"POINT(-66.214847 41.627502)",1984,1993,9,"9",10932
"POINT(-66.291594 46.666605)",1970,2014,44,"45",12888
"POINT(-55.69917 47.88361)",1987,2010,23,"24",11221
"POINT(-61.56738 44.19795)",1995,2016,21,"21",11803
"POINT(-61.56738 44.19795)",1995,2016,21,"22",11502
"POINT(-65.50048 43.2532)",1982,1994,12,"13",12431
"POINT(-48.33984 44.59046)",1977,2000,23,"24",14262
"POINT(-83.05 42.033333)",1974,2004,30,"30",12898
"POINT(-69.666667 48.15)",1994,2004,10,"11",12915
"POINT(-66.214847 41.627502)",1980,1993,13,"10",10645
"POINT(-52 50)",1962,1992,30,"31",13294
"POINT(-52.782383 44.683779)",1972,1994,22,"19",10463
"POINT(-63.902612 46.237205)",2001,2006,5,"6",10079
"POINT(-61.56738 44.19795)",1995,2016,21,"22",12580
"POINT(-65.50048 43.2532)",1982,1994,12,"13",11630
"POINT(-79.361398 43.62142)",2006,2012,6,"4",13575
"POINT(-65.50048 43.2532)",1995,2016,21,"22",11324
"POINT(-64.657552 47.746584)",2011,2014,3,"2",15285
"POINT(-65.50048 43.2532)",1970,1981,11,"12",12497
"POINT(-65.63232 43.2452)",1970,2002,32,"33",14235
"POINT(-74.381869 45.160229)",2002,2016,14,"3",13991
"POINT(-64.861867 46.665292)",2006,2010,4,"5",15481
"POINT(-61.56738 44.19795)",1999,2014,15,"9",11640
"POINT(-65.63232 43.2452)",1982,2006,24,"25",14341
"POINT(-68.615921 41.275324)",1970,2016,46,"47",14794
"POINT(-74.018383 39.10066)",1971,2016,45,"46",14620
"POINT(-65.50048 43.2532)",1982,1994,12,"13",11829
"POINT(-63 47)",1971,2016,45,"46",10017
"POINT(-77.59299 44.01301)",2008,2015,7,"2",13800
"POINT(-61.56738 44.19795)",1971,1981,10,"6",12457
"POINT(-74.931907 47.16858)",1972,2012,40,"32",11306
"POINT(-64.11454 46.1827)",2011,2014,3,"2",15305
"POINT(-72.47958 46.88236)",2016,2021,5,"2",15940
"POINT(-64.710486 46.475972)",2004,2010,6,"7",15129
"POINT(-67 43)",1970,2010,40,"41",14389
"POINT(-68.615921 41.275324)",1963,2009,46,"47",14429
"POINT(-65.098835 42.729563)",1970,1994,24,"25",10614
"POINT(-49.931212 51.171824)",1983,2011,28,"29",14409
"POINT(-65.50048 43.2532)",1995,2016,21,"12",12559
"POINT(-65.50048 43.2532)",1971,1979,8,"3",12112
"POINT(-74.381869 45.160229)",1984,2018,34,"17",13700
"POINT(-61.56738 44.19795)",1970,1981,11,"12",11663
"POINT(-70.87637 46.85767)",2016,2019,3,"2",15973
"POINT(-63 47)",1978,1990,12,"13",13162
"POINT(-61.181309 42.866877)",1970,1993,23,"24",10340
"POINT(-61.56738 44.19795)",1982,1994,12,"13",12091
"POINT(-65.63232 43.2452)",1970,2007,37,"38",14404
"POINT(-75.363333 35.224444)",1992,1993,1,"2",12730
"POINT(-63.188167 45.760967)",2011,2014,3,"2",15495
"POINT(-61.56738 44.19795)",1986,1988,2,"2",12283
"POINT(-86 50)",1970,2014,44,"45",12661
"POINT(-65.50048 43.2532)",1995,2016,21,"22",12488
"POINT(-65.50048 43.2532)",2001,2014,13,"7",12459
"POINT(-79.361398 43.62142)",2006,2012,6,"4",13470
"POINT(-52.121122 50.695322)",1973,1984,11,"5",10838
"POINT(-61.56738 44.19795)",1970,1981,11,"12",12503
"POINT(-61.56738 44.19795)",1972,1981,9,"2",11377
"POINT(-61.017433 46.6243)",2011,2014,3,"2",15780
"POINT(-77.229936 44.152886)",1992,2018,26,"27",13719
"POINT(-70.87637 46.85767)",2016,2021,5,"6",16238
"POINT(-57.854 44.91813)",1970,2002,32,"33",14231
"POINT(-65.63232 43.2452)",1970,2007,37,"38",14354
"POINT(-84.499722 49.25)",1995,2004,9,"9",9963
"POINT(-79.361398 43.62142)",2006,2012,6,"4",13521
"POINT(-77.072526 44.096244)",1992,2018,26,"27",13610
"POINT(-49.931212 51.171824)",1983,2011,28,"29",14259
"POINT(-67.5 40.4)",1955,1987,32,"33",13383
"POINT(-62.11238 46.383134)",2005,2008,3,"2",15051
"POINT(-77.229936 44.152886)",1992,2018,26,"27",13653
"POINT(-61.56738 44.19795)",1995,2016,21,"22",11976
"POINT(-56.766309 56.477534)",1978,1991,13,"9",10544
"POINT(-69.041914 40.95268)",1969,2008,39,"40",14420
"POINT(-61.56738 44.19795)",1995,2010,15,"11",11892
"POINT(-53.864595 53.910492)",1970,1994,24,"20",10288
"POINT(-74.018383 39.10066)",1971,2016,45,"46",14760
"POINT(-59.853639 59.286076)",1978,1991,13,"6",10918
"POINT(-61.56738 44.19795)",1970,1981,11,"4",11613
"POINT(-63.728047 47.637685)",1970,1994,24,"25",10458
"POINT(-68.615921 41.275324)",1970,2016,46,"47",14430
"POINT(-64.11454 46.1827)",2011,2014,3,"2",15749
"POINT(-68.526458 40.575228)",1964,2016,52,"53",14686
"POINT(-82.134735 48.575324)",2002,2004,2,"3",10104
"POINT(-59.822611 42.550438)",1983,2008,25,"16",11249
"POINT(-62.735984 45.290147)",1970,2014,44,"45",12801
"POINT(-53.864595 53.910492)",1977,1986,9,"4",10495
"POINT(-72 54)",1970,2014,44,"45",12676
"POINT(-59 49.25)",1965,2017,52,"53",14695
"POINT(-74.018383 39.10066)",1973,2002,29,"30",14371
"POINT(-70.87637 46.85767)",2016,2021,5,"6",15981
"POINT(-58.635512 47.364248)",1974,1991,17,"6",10666
"POINT(-77.229936 44.152886)",1992,2018,26,"27",13715
"POINT(-66.486934 47.136578)",2001,2002,1,"2",15860
"POINT(-65.50048 43.2532)",1998,2009,11,"7",11772
"POINT(-69 43)",1967,1989,22,"23",13271
"POINT(-78.523333 45.595278)",1952,1995,43,"43",12963
"POINT(-52.782383 44.683779)",1970,1994,24,"23",10751
"POINT(-52.121122 50.695322)",1970,1993,23,"14",10901
"POINT(-64.710486 46.475972)",2011,2014,3,"2",15265
"POINT(-79.361398 43.62142)",2006,2012,6,"4",13490
"POINT(-61.56738 44.19795)",1970,1981,11,"12",12291
"POINT(-64.873712 47.473463)",2005,2010,5,"6",15200
"POINT(-86 50)",1970,2014,44,"45",12786
"POINT(-72 54)",1970,2014,44,"45",12843
"POINT(-61.56738 44.19795)",1995,2016,21,"22",12313
"POINT(-65.50048 43.2532)",1995,2016,21,"22",12629
"POINT(-72.88129 46.69751)",2016,2021,5,"6",15927
"POINT(-78.56511 67.35631)",1988,1989,1,"2",12990
"POINT(-52.121122 50.695322)",1970,1994,24,"17",10316
"POINT(-65.50048 43.2532)",1982,1994,12,"13",11889
"POINT(-72.88129 46.69751)",2016,2020,4,"2",16239
"POINT(-57.05 51)",1971,1995,24,"25",13337
"POINT(-76.26806 36.03472)",1991,2001,10,"11",9951
"POINT(-61.56738 44.19795)",1982,1994,12,"13",11770
"POINT(-61.56738 44.19795)",1982,1994,12,"13",11798
"POINT(-63.06152 46.75491)",1978,2018,40,"41",14774
"POINT(-61.56738 44.19795)",1972,1981,9,"6",11805
"POINT(-48.33984 44.59046)",1977,2000,23,"24",14212
"POINT(-65.029957 47.777114)",2011,2014,3,"2",15502
"POINT(-79.0275 38.571111)",1976,1982,6,"7",10066
"POINT(-56.383301 46.711721)",1996,2008,12,"5",14867
"POINT(-73.107078 52.941847)",1970,2014,44,"45",12822
"POINT(-73.795833 45.016389)",2003,2004,1,"2",13076
"POINT(-67.5 40.4)",1955,1987,32,"33",13173
"POINT(-52.782383 44.683779)",1981,1993,12,"5",11004
"POINT(-63.758716 46.383956)",2007,2010,3,"4",15203
"POINT(-61.56738 44.19795)",1982,1994,12,"6",12107
"POINT(-61.56738 44.19795)",1982,1994,12,"13",12531
"POINT(-73.19306 45.5675)",1966,1976,10,"10",12978
"POINT(-78.523333 45.595278)",1972,1991,19,"19",12943
"POINT(-68.615921 41.275324)",1963,2009,46,"47",14653
"POINT(-52.782383 44.683779)",1970,1994,24,"22",10852
"POINT(-65.8 45)",1970,2001,31,"32",11155
"POINT(-81.856583 42.276928)",2004,2008,4,"4",11163
"POINT(-59.853639 59.286076)",1978,1991,13,"6",10355
"POINT(-65.50048 43.2532)",1982,1994,12,"13",12634
"POINT(-71.093778 40.671798)",1989,2016,27,"28",14601
"POINT(-57.690888 43.437611)",1981,1990,9,"6",10498
"POINT(-61.181309 42.866877)",1979,1994,15,"11",10755
"POINT(-72.47958 46.88236)",2016,2021,5,"2",16185
"POINT(-48.319336 48.138699)",1996,2010,14,"15",14946
"POINT(-61.56738 44.19795)",1982,1984,2,"2",11809
"POINT(-51 49.15)",1980,1996,16,"17",13157
"POINT(-66.05139 45.26667)",1968,1988,20,"21",13429
"POINT(-61.017433 46.6243)",2008,2010,2,"3",15548
"POINT(-77.072526 44.096244)",1992,2018,26,"27",13726
"POINT(-63.802767 46.136433)",2011,2014,3,"2",15504
"POINT(-70.87637 46.85767)",2016,2021,5,"6",15926
"POINT(-49.956886 45.114711)",1972,1994,22,"16",10820
"POINT(-57.690888 43.437611)",1970,1994,24,"25",10167
"POINT(-72.47958 46.88236)",2016,2021,5,"2",16139
"POINT(-82.517801 41.970728)",2002,2003,1,"2",15039
"POINT(-65.50048 43.2532)",1995,2016,21,"22",12049
"POINT(-62.74132 45.67583)",2006,2009,3,"4",15703
"POINT(-72.82857 45.04889)",2016,2021,5,"3",16187
"POINT(-72 54)",1970,2014,44,"45",12847
"POINT(-73.43806 38.53306)",1963,2009,46,"47",14586
"POINT(-63.188167 45.760967)",2009,2010,1,"2",15201
"POINT(-61.56738 44.19795)",1995,2016,21,"22",12598
"POINT(-64.951922 46.75123)",2004,2010,6,"7",15204
"POINT(-58.02978 50.13466)",1973,2003,30,"31",14342
"POINT(-64.951922 46.75123)",2011,2014,3,"2",15609
"POINT(-64.657552 47.746584)",2011,2014,3,"2",15241
"POINT(-65.57426 46.98624)",2011,2014,3,"2",15552
"POINT(-77.22225 44.149251)",2001,2015,14,"14",13778
"POINT(-77.80861 43.698439)",1997,2012,15,"14",13513
"POINT(-86 50)",1970,2014,44,"45",12787
"POINT(-77.396957 43.50608)",1997,2018,21,"22",14031
"POINT(-61.56738 44.19795)",1971,1981,10,"6",11923
"POINT(-63.728047 47.637685)",1970,1994,24,"25",10605
"POINT(-58.452138 49.69674)",1972,1992,20,"11",10493
"POINT(-77.229936 44.152886)",1992,2018,26,"27",13764
"POINT(-55.995809 46.034584)",1970,1994,24,"24",11044
"POINT(-55.995809 46.034584)",1974,1994,20,"8",10284
"POINT(-69.041914 40.95268)",1967,2014,47,"48",14561
"POINT(-65.50048 43.2532)",1995,2016,21,"22",12067
"POINT(-62.74132 45.67583)",2004,2010,6,"7",15406
"POINT(-69.041914 40.95268)",1984,2016,32,"33",14783
"POINT(-65.090012 44.451082)",1996,1997,1,"2",14102
"POINT(-61.56738 44.19795)",1985,1994,9,"4",12309
"POINT(-68.615921 41.275324)",1963,2016,53,"54",14512
"POINT(-74.018383 39.10066)",1968,2011,43,"44",14594
"POINT(-65.50048 43.2532)",1970,1981,11,"12",11746
"POINT(-63.728047 47.637685)",1970,1994,24,"25",10954
"POINT(-61.56738 44.19795)",1985,1994,9,"8",12239
"POINT(-65.098835 42.729563)",1983,1994,11,"6",10599
"POINT(-61.56738 44.19795)",1982,1994,12,"13",12348
"POINT(-70.87637 46.85767)",2020,2021,1,"2",16076
"POINT(-63.446958 46.46855)",2004,2010,6,"7",15199
"POINT(-69.66667 48)",1988,2002,14,"7",11223
"POINT(-72.88129 46.69751)",2016,2021,5,"6",16050
"POINT(-65.50048 43.2532)",2006,2014,8,"3",12607
"POINT(-61.56738 44.19795)",1972,1981,9,"6",12072
"POINT(-59.853639 59.286076)",1978,1991,13,"6",10564
"POINT(-71.093778 40.671798)",1989,2016,27,"28",14573
"POINT(-70.87637 46.85767)",2018,2021,3,"2",16022
"POINT(-77.22225 44.149251)",2001,2015,14,"14",13871
"POINT(-56.766309 56.477534)",1977,1991,14,"11",10597
"POINT(-79.85068 43.28331)",2006,2015,9,"6",13776
"POINT(-79.361398 43.62142)",2006,2012,6,"4",13525
"POINT(-61.455567 46.07815)",2011,2014,3,"2",15810
"POINT(-65.098835 42.729563)",1970,1994,24,"25",10169
"POINT(-65.50048 43.2532)",1970,1981,11,"12",12623
"POINT(-53.864595 53.910492)",1970,1994,24,"23",11049
"POINT(-62.067902 49.652037)",1978,1990,12,"6",10966
"POINT(-68.615921 41.275324)",1963,2005,42,"43",14222
"POINT(-62.067902 49.652037)",1978,1992,14,"9",10383
"POINT(-65.3 43)",1962,1988,26,"27",13324
"POINT(-61.56738 44.19795)",1970,1981,11,"4",11346
"POINT(-60.79843 53.003392)",1980,2014,34,"35",12804
"POINT(-61.56738 44.19795)",1982,1994,12,"13",12511
"POINT(-77.547686 43.947746)",1992,2012,20,"21",13483
"POINT(-74.381869 45.160229)",1994,2018,24,"4",13932
"POINT(-59.348941 46.441917)",1970,1994,24,"22",10457
"POINT(-74.381869 45.160229)",2012,2018,6,"4",13956
"POINT(-63.888896 46.512101)",2009,2010,1,"2",15692
"POINT(-69 43)",1967,1989,22,"23",13292
"POINT(-63.466588 46.348013)",1969,2014,45,"46",11148
"POINT(-72.88129 46.69751)",2019,2020,1,"2",16002
"POINT(-61.181309 42.866877)",1970,1994,24,"25",10179
"POINT(-64.11454 46.1827)",2009,2010,1,"2",15049
"POINT(-61.56738 44.19795)",1982,1994,12,"13",12358
"POINT(-61.56738 44.19795)",1995,2016,21,"15",12647
"POINT(-64.8083 47.67109)",2009,2010,1,"2",15687
"POINT(-74.381869 45.160229)",1984,2014,30,"6",13959
"POINT(-70.87637 46.85767)",2018,2019,1,"2",15882
"POINT(-84.499722 49.25)",1995,2004,9,"9",9960
"POINT(-62.735984 45.290147)",1970,2014,44,"45",12881
"POINT(-68.615921 41.275324)",1963,2005,42,"43",14248
"POINT(-65.50048 43.2532)",1996,2016,20,"18",11807
"POINT(-76.793641 37.5234)",2013,2018,5,"6",13025
"POINT(-55.995809 46.034584)",1976,1994,18,"7",11034
"POINT(-49.956886 45.114711)",1984,1994,10,"8",10484
"POINT(-61.56738 44.19795)",1995,2016,21,"22",11567
"POINT(-73.512303 49.07891)",1983,1993,10,"10",13065
"POINT(-77.547686 43.947746)",1992,2012,20,"21",13563
"POINT(-65.50048 43.2532)",1999,2013,14,"3",11445
"POINT(-74.381869 45.160229)",1984,2018,34,"17",13757
"POINT(-61.56738 44.19795)",1995,2016,21,"22",12172
"POINT(-63.728047 47.637685)",1984,1994,10,"11",10860
"POINT(-61.56738 44.19795)",1972,1973,1,"2",12381
"POINT(-61.56738 44.19795)",1995,2016,21,"22",12357
"POINT(-56.383301 46.711721)",1996,2010,14,"14",14962
"POINT(-48.319336 48.138699)",1996,2010,14,"15",14970
"POINT(-65.50048 43.2532)",2011,2013,2,"2",12017
"POINT(-65.090012 44.451082)",1996,1997,1,"2",14060
"POINT(-76.06 44.055)",1976,2016,40,"41",13058
"POINT(-73.43806 38.53306)",1963,2009,46,"47",14474
"POINT(-76.794435 44.062208)",1992,2018,26,"27",13964
"POINT(-86 50)",1970,2014,44,"45",12853
"POINT(-62.74132 45.67583)",2004,2010,6,"7",15327
"POINT(-52.121122 50.695322)",1971,1985,14,"8",11104
"POINT(-66.291594 46.666605)",1970,2014,44,"45",12821
"POINT(-71.0925 44.915556)",1999,2010,11,"12",13085
"POINT(-61.56738 44.19795)",1982,1994,12,"13",11401
"POINT(-65.50048 43.2532)",1996,2015,19,"10",11331
"POINT(-65.50048 43.2532)",1995,2016,21,"17",12438
"POINT(-78.291582 43.944964)",1987,2016,29,"30",13961
"POINT(-57.690888 43.437611)",1972,1993,21,"18",10690
"POINT(-61.181309 42.866877)",1970,1994,24,"25",10177
"POINT(-67.86528 44.36722)",1968,1998,30,"26",9945
"POINT(-72.47958 46.88236)",2016,2021,5,"2",15933
"POINT(-61.56738 44.19795)",1995,2016,21,"21",12238
"POINT(-77.396972 43.506083)",1997,2018,21,"9",13904
"POINT(-64.951922 46.75123)",2004,2010,6,"7",15317
"POINT(-61.181309 42.866877)",1982,1987,5,"5",10920
"POINT(-61.1985 45.9668)",1996,1997,1,"2",14085
"POINT(-63 47)",1971,2016,45,"40",10022
"POINT(-65.029957 47.777114)",2004,2010,6,"7",15095
"POINT(-61.56738 44.19795)",1995,2009,14,"7",11878
"POINT(-61.56738 44.19795)",1995,2016,21,"22",11462
"POINT(-66.11572 44.8247)",1997,2012,15,"16",14745
"POINT(-61.56738 44.19795)",1970,1981,11,"12",11526
"POINT(-61.56738 44.19795)",1982,1994,12,"13",11434
"POINT(-77.22225 44.149251)",2001,2015,14,"14",13891
"POINT(-61.56738 44.19795)",1982,1994,12,"9",11477
"POINT(-62.067902 49.652037)",1972,1994,22,"22",10207
"POINT(-65.50048 43.2532)",1982,1994,12,"13",11566
"POINT(-65.50048 43.2532)",2001,2014,13,"7",11658
"POINT(-66.214847 41.627502)",1980,1993,13,"10",11123
"POINT(-65.50048 43.2532)",1982,1994,12,"13",12156
"POINT(-58.452138 49.69674)",1985,1994,9,"9",10481
"POINT(-59.12841 47.47266)",1974,2010,36,"37",14804
"POINT(-61.56738 44.19795)",1995,2016,21,"21",12552
"POINT(-77.72313 43.99472)",2008,2015,7,"2",13827
"POINT(-62.28626 46.36766)",2011,2014,3,"2",15182
"POINT(-65.50048 43.2532)",1995,2016,21,"22",12175
"POINT(-51 49.15)",1980,1996,16,"17",13241
"POINT(-77.22225 44.149251)",2001,2015,14,"14",13839
"POINT(-65.50048 43.2532)",1983,1991,8,"6",11511
"POINT(-77.229936 44.152886)",1992,2018,26,"27",13962
"POINT(-52.782383 44.683779)",1970,1994,24,"24",10211
"POINT(-74.018383 39.10066)",1968,2011,43,"44",14510
"POINT(-62.44628 43.89789)",1974,2008,34,"35",14163
"POINT(-61.56738 44.19795)",1970,1978,8,"3",11334
"POINT(-72 40)",1973,2016,43,"44",14501
"POINT(-63.446958 46.46855)",2011,2014,3,"2",15607
"POINT(-74.58861 36.44722)",1985,2014,29,"30",14548
"POINT(-64.965766 47.341712)",2011,2014,3,"2",15608
"POINT(-76.794435 44.062208)",1992,2018,26,"27",13623
"POINT(-71.71751 46.41901)",2018,2021,3,"4",16048
"POINT(-63.739472 45.85055)",2005,2009,4,"5",15209
"POINT(-62.547863 46.172776)",2011,2014,3,"2",15751
"POINT(-82.134735 48.575324)",2002,2004,2,"3",10106
"POINT(-61.1985 45.9668)",1996,1997,1,"2",14053
"POINT(-61.56738 44.19795)",1995,2016,21,"22",12226
"POINT(-77.396957 43.50608)",1997,2018,21,"22",14010
"POINT(-52.940252 44.204538)",1996,2009,13,"13",14852
"POINT(-61.56738 44.19795)",1984,1994,10,"10",12436
"POINT(-52.121122 50.695322)",1970,1984,14,"3",10753
"POINT(-61.56738 44.19795)",1982,1994,12,"13",11935
"POINT(-63 47)",1971,2016,45,"45",10049
"POINT(-53.172992 49.757443)",1995,2012,17,"18",11287
"POINT(-64.554866 46.218937)",2004,2010,6,"4",15562
"POINT(-76.06 44.055)",1976,2015,39,"38",13045
"POINT(-61.56738 44.19795)",1977,1981,4,"2",12131
"POINT(-79.361398 43.62142)",2006,2012,6,"4",13548
"POINT(-77.80861 43.698439)",1997,2012,15,"14",13540
"POINT(-55.995809 46.034584)",1976,1994,18,"4",10314
"POINT(-77.547686 43.947746)",1992,2018,26,"27",13629
"POINT(-72.957967 46.778085)",1975,2007,32,"3",15834
"POINT(-52.782383 44.683779)",1970,1994,24,"22",10311
"POINT(-56.383301 46.711721)",1984,1991,7,"5",14942
"POINT(-61.56738 44.19795)",1982,1994,12,"13",11991
"POINT(-66.11572 44.8247)",1997,2012,15,"16",14689
"POINT(-61.164851 45.857738)",1996,1997,1,"2",14103
"POINT(-52.121122 50.695322)",1970,1994,24,"24",10147
"POINT(-61.56738 44.19795)",1998,2006,8,"3",11711
"POINT(-58.452138 49.69674)",1985,1989,4,"4",10300
"POINT(-63.2 42)",1973,1986,13,"14",13139
"POINT(-77.72313 43.99472)",2008,2015,7,"2",13838
"POINT(-63.66575 45.8547)",2011,2014,3,"2",15289
"POINT(-65.029957 47.777114)",2011,2014,3,"2",15472
"POINT(-79.85068 43.28331)",2006,2015,9,"6",13789
"POINT(-66.291594 46.666605)",1970,2014,44,"45",12708
"POINT(-58.452138 49.69674)",1971,1994,23,"20",10871
"POINT(-63 47)",1985,2015,30,"16",10063
"POINT(-77.072526 44.096244)",1992,2018,26,"27",13732
"POINT(-86 50)",1970,2014,44,"45",12793
"POINT(-61.56738 44.19795)",1983,1994,11,"12",12619
"POINT(-74.381869 45.160229)",1990,2018,28,"3",13952
"POINT(-57.41455 46.93526)",1983,2011,28,"28",14158
"POINT(-65.50048 43.2532)",1995,2016,21,"20",11810
"POINT(-64.965766 47.341712)",2011,2014,3,"2",15496
"POINT(-59.348941 46.441917)",1970,1994,24,"4",10234
"POINT(-52.121122 50.695322)",1970,1994,24,"23",10961
"POINT(-61.56738 44.19795)",1972,1973,1,"2",12114
"POINT(-61.181309 42.866877)",1974,1994,20,"20",10801
"POINT(-71.71751 46.41901)",2016,2019,3,"4",16182
"POINT(-63.728047 47.637685)",1974,1994,20,"17",10491
"POINT(-50.521046 49.772834)",1975,2006,31,"32",14450
"POINT(-65.57426 46.98624)",2011,2014,3,"2",15381
"POINT(-61.56738 44.19795)",1995,2016,21,"22",12001
"POINT(-69.041914 40.95268)",1967,2014,47,"48",14449
"POINT(-76.554165 38.536619)",1957,2006,49,"50",9940
"POINT(-56.766309 56.477534)",1978,1991,13,"9",10700
"POINT(-47.315252 41.630515)",1996,2009,13,"11",14847
"POINT(-64.646046 47.789535)",2005,2009,4,"3",15486
"POINT(-65.998611 46.5)",1974,2006,32,"33",12981
"POINT(-61.56738 44.19795)",1989,1993,4,"2",11676
"POINT(-71.093778 40.671798)",1967,2005,38,"39",14150
"POINT(-71.753435 43.955654)",2012,2018,6,"5",13093
"POINT(-62.067902 49.652037)",1978,1994,16,"13",10861
"POINT(-57.41455 46.93526)",1983,2011,28,"28",14258
"POINT(-74.018383 39.10066)",1975,2005,30,"31",14270
"POINT(-76.06 44.055)",1978,1998,20,"13",13053
"POINT(-53.864595 53.910492)",1982,1993,11,"11",10625
"POINT(-51.19117 50.037337)",1978,1994,16,"17",11201
"POINT(-61.56738 44.19795)",1995,2016,21,"21",12285
"POINT(-86 50)",1970,2014,44,"45",12689
"POINT(-53.183333 49.75)",2000,2003,3,"3",11183
"POINT(-65.50048 43.2532)",1970,1981,11,"11",11631
"POINT(-65.50048 43.2532)",1995,2016,21,"22",12601
"POINT(-65.098835 42.729563)",1970,1994,24,"25",10742
"POINT(-61.56738 44.19795)",1995,2016,21,"18",12455
"POINT(-53.37158 51.46769)",1979,2011,32,"33",14721
"POINT(-69.666667 48.15)",1994,2005,11,"12",12911
"POINT(-63.728047 47.637685)",1970,1994,24,"20",11119
"POINT(-73.107078 52.941847)",1970,2014,44,"45",12811
"POINT(-67.064717 44.266029)",1980,1993,13,"8",11082
"POINT(-63.14804 46.23122)",2006,2010,4,"3",15090
"POINT(-77.547686 43.947746)",1992,2018,26,"27",13747
"POINT(-71.71751 46.41901)",2018,2021,3,"4",16001
"POINT(-61.1985 45.9668)",1996,1997,1,"2",14069
"POINT(-61.56738 44.19795)",1982,1994,12,"13",12202
"POINT(-65.562778 46.995278)",2004,2009,5,"3",15704
"POINT(-61.56738 44.19795)",1995,2016,21,"22",11638
"POINT(-61.56738 44.19795)",1970,1981,11,"12",11739
"POINT(-68.871657 43.27657)",1982,2014,32,"33",14679
"POINT(-61.56738 44.19795)",1983,1994,11,"11",11583
"POINT(-80.98194 43.37)",1992,1994,2,"3",13005
"POINT(-65.50048 43.2532)",2006,2014,8,"3",12073
"POINT(-61.181309 42.866877)",1970,1994,24,"25",10249
"POINT(-56.383301 46.711721)",1996,2010,14,"14",14914
"POINT(-72 40)",1973,2016,43,"44",14557
"POINT(-61.56738 44.19795)",1982,1994,12,"13",11525
"POINT(-52.121122 50.695322)",1970,1994,24,"22",10242
"POINT(-72.82857 45.04889)",2016,2021,5,"3",16038
"POINT(-62.735984 45.290147)",1970,2014,44,"45",12813
"POINT(-65.50048 43.2532)",1982,1994,12,"13",11455
"POINT(-69 43)",1967,1989,22,"23",13335
"POINT(-82.517801 41.970728)",2002,2003,1,"2",15019
"POINT(-61.56738 44.19795)",1970,1981,11,"4",11880
"POINT(-61.017433 46.6243)",2011,2014,3,"2",15190
"POINT(-64.8083 47.67109)",2009,2010,1,"2",15404
"POINT(-63.446958 46.46855)",2011,2014,3,"2",15347
"POINT(-72.82857 45.04889)",2019,2021,2,"2",16127
"POINT(-76.79121 49.01888)",2019,2019,0,"2",16095
"POINT(-61.56738 44.19795)",1970,1981,11,"12",12141
"POINT(-67.86528 44.36722)",1968,1998,30,"26",9941
"POINT(-66.291594 46.666605)",1970,2014,44,"45",12875
"POINT(-59.609137 49.495564)",1987,2010,23,"24",11269
"POINT(-61.455567 46.07815)",2011,2014,3,"2",15778
"POINT(-60.3 44.1)",1967,1990,23,"24",13185
"POINT(-65.50048 43.2532)",1995,2016,21,"22",11836
"POINT(-74.381869 45.160229)",1984,2018,34,"17",13751
"POINT(-67 43)",1970,2010,40,"41",14314
"POINT(-72.88129 46.69751)",2016,2021,5,"6",15883
"POINT(-61.56738 44.19795)",1983,1994,11,"11",11850
"POINT(-60.3 44.1)",1967,1990,23,"24",13311
"POINT(-50.75978 47.607599)",1970,1994,24,"25",10146
"POINT(-65.30028 44.36972)",1987,2017,30,"29",14974
"POINT(-74.018383 39.10066)",1982,2015,33,"34",14565
"POINT(-50.370609 48.414273)",1977,2000,23,"24",14143
"POINT(-65.50048 43.2532)",1970,1981,11,"12",12200
"POINT(-74.381869 45.160229)",2000,2016,16,"5",13918
"POINT(-86 50)",1970,2014,44,"45",12791
"POINT(-52.121122 50.695322)",1970,1994,24,"22",10789
"POINT(-66.214847 41.627502)",1980,1993,13,"11",11092
"POINT(-86 50)",1970,2014,44,"45",12691
"POINT(-61.56738 44.19795)",1982,1994,12,"13",11471
"POINT(-65.50048 43.2532)",1995,2016,21,"22",11869
"POINT(-55.995809 46.034584)",1974,1994,20,"10",11001
"POINT(-53.864595 53.910492)",1970,1994,24,"24",10962
"POINT(-65.029957 47.777114)",2005,2009,4,"4",15490
"POINT(-72.82857 45.04889)",2016,2019,3,"2",15971
"POINT(-63.66575 45.8547)",2011,2014,3,"2",15173
"POINT(-49.956886 45.114711)",1970,1993,23,"10",11047
"POINT(-65.50048 43.2532)",1995,2016,21,"22",12055
"POINT(-65.50048 43.2532)",1995,2016,21,"8",11826
"POINT(-61.56738 44.19795)",1996,2016,20,"11",11953
"POINT(-62.067902 49.652037)",1972,1994,22,"5",10707
"POINT(-63.728047 47.637685)",1984,1994,10,"10",10706
"POINT(-65.50048 43.2532)",1995,2016,21,"22",12019
"POINT(-63.66575 45.8547)",2005,2006,1,"2",15058
"POINT(-65.50048 43.2532)",1970,1981,11,"12",11673
"POINT(-56.00467 49.66372)",2015,2016,1,"2",11312
"POINT(-65.50048 43.2532)",1995,2016,21,"22",11752
"POINT(-64.710486 46.475972)",2004,2010,6,"7",15539
"POINT(-65.50048 43.2532)",1970,1981,11,"12",12207
"POINT(-59.853639 59.286076)",1978,1991,13,"5",10389
"POINT(-65.50048 43.2532)",1995,2016,21,"12",11491
"POINT(-65.50048 43.2532)",1995,2016,21,"22",11788
"POINT(-79.240319 42.87999)",2003,2008,5,"6",11162
"POINT(-79.85068 43.28331)",2006,2015,9,"6",13884
"POINT(-65.50048 43.2532)",1995,2016,21,"21",12420
"POINT(-65.098835 42.729563)",1970,1994,24,"25",10248
"POINT(-72.88129 46.69751)",2020,2021,1,"2",16069
"POINT(-72.88129 46.69751)",2018,2019,1,"2",16099
"POINT(-61.56738 44.19795)",1977,1981,4,"2",12398
"POINT(-59.853639 59.286076)",1978,1988,10,"5",10276
"POINT(-77.229936 44.152886)",1992,2018,26,"27",13766
"POINT(-77.547686 43.947746)",1992,2012,20,"21",13564
"POINT(-56.766309 56.477534)",1978,1991,13,"10",10215
"POINT(-65.50048 43.2532)",1990,1994,4,"2",11952
"POINT(-63.728047 47.637685)",1970,1994,24,"25",10909
"POINT(-63.126667 46.235)",1998,1999,1,"2",14984
"POINT(-71.71751 46.41901)",2017,2020,3,"2",16225
"POINT(-59.853639 59.286076)",1978,1991,13,"6",10245
"POINT(-72 54)",1970,2014,44,"45",12859
"POINT(-77.229936 44.152886)",1992,2018,26,"27",14046
"POINT(-63.188167 45.760967)",2011,2014,3,"2",15728
"POINT(-84.499722 49.25)",1979,2004,25,"26",13031
"POINT(-63.888896 46.512101)",2009,2010,1,"2",15331
"POINT(-61.56738 44.19795)",1984,1992,8,"7",11643
"POINT(-64.951922 46.75123)",2004,2010,6,"7",15396
"POINT(-62.067902 49.652037)",1980,1987,7,"3",10936
"POINT(-59.348941 46.441917)",1970,1994,24,"15",10649
"POINT(-61.56738 44.19795)",1989,1993,4,"2",11943
"POINT(-69.041914 40.95268)",1967,2014,47,"48",14729
"POINT(-78.523333 45.595278)",1972,1991,19,"19",12957
"POINT(-63.427139 46.193528)",2011,2014,3,"2",15746
"POINT(-72.82857 45.04889)",2016,2021,5,"2",16059
"POINT(-64.951922 46.75123)",2004,2010,6,"7",15787
"POINT(-51.19117 50.037337)",1995,2001,6,"7",11200
"POINT(-72.88129 46.69751)",2016,2021,5,"6",16125
"POINT(-65.098835 42.729563)",1970,1994,24,"20",10293
"POINT(-65.50048 43.2532)",1995,2016,21,"22",12061
"POINT(-74.381869 45.160229)",2006,2018,12,"7",14020
"POINT(-72 54)",1970,2014,44,"45",12832
"POINT(-63 47)",1974,2016,42,"41",10057
"POINT(-74.58861 36.44722)",1981,2008,27,"28",14278
"POINT(-77.547686 43.947746)",1992,2018,26,"27",13691
"POINT(-69.041914 40.95268)",1984,2016,32,"33",14559
"POINT(-71.093778 40.671798)",1989,2016,27,"28",14797
"POINT(-72 40)",1973,2016,43,"44",14417
"POINT(-71.71751 46.41901)",2016,2021,5,"6",15925
"POINT(-72.88129 46.69751)",2016,2021,5,"5",16118
"POINT(-57.690888 43.437611)",1970,1994,24,"21",10434
"POINT(-58.02978 50.13466)",1973,2003,30,"31",14392
"POINT(-63.888896 46.512101)",2009,2010,1,"2",15117
"POINT(-79.361398 43.62142)",2006,2012,6,"4",13477
"POINT(-58.452138 49.69674)",1972,1990,18,"11",10283
"POINT(-65.50048 43.2532)",1995,2016,21,"22",11759
"POINT(-71.71751 46.41901)",2017,2021,4,"5",16045
"POINT(-61.181309 42.866877)",1970,1994,24,"18",10278
"POINT(-71.735654 43.931506)",2012,2014,2,"3",13088
"POINT(-69.041914 40.95268)",1984,2016,32,"33",14699
"POINT(-52.782383 44.683779)",1977,1994,17,"8",10326
"POINT(-68.615921 41.275324)",1950,2016,66,"67",14432
"POINT(-75.79163 45.64647)",2011,2013,2,"3",11171
"POINT(-82.685774 42.433516)",1999,2000,1,"2",15813
"POINT(-58.635512 47.364248)",1971,1994,23,"23",10750
"POINT(-63.126667 46.235)",1998,1999,1,"2",14977
"POINT(-63.728047 47.637685)",1972,1994,22,"23",10617
"POINT(-61.28389 47.21917)",1987,2011,24,"25",11202
"POINT(-52.757812 52.054271)",1977,1994,17,"18",14887
"POINT(-67 43)",1970,2010,40,"41",14364
"POINT(-64.873712 47.473463)",2005,2010,5,"6",15069
"POINT(-49.956886 45.114711)",1970,1994,24,"24",10258
"POINT(-65.50048 43.2532)",1982,1994,12,"13",11965
"POINT(-74.381869 45.160229)",1984,2018,34,"17",13635
"POINT(-72.47958 46.88236)",2016,2021,5,"2",15969
"POINT(-65.63232 43.2452)",1970,2007,37,"38",14279
"POINT(-77.03167 38.89667)",1961,1986,25,"17",13431
"POINT(-48.319336 48.138699)",1975,1982,7,"8",14904
"POINT(-61.017433 46.6243)",2008,2010,2,"3",15648
"POINT(-71.093778 40.671798)",1989,2016,27,"28",14433
"POINT(-63.728047 47.637685)",1971,1994,23,"23",10252
"POINT(-64.710486 46.475972)",2004,2010,6,"7",15099
"POINT(-65.50048 43.2532)",1982,1994,12,"8",12191
"POINT(-52.121122 50.695322)",1975,1989,14,"9",10494
"POINT(-50.521046 49.772834)",1975,2006,31,"32",14758
"POINT(-50.521046 49.772834)",1975,2006,31,"32",14590
"POINT(-64.657552 47.746584)",2011,2014,3,"2",15732
"POINT(-68.615921 41.275324)",1963,2009,46,"47",14485
"POINT(-63.758716 46.383956)",2007,2010,3,"4",15072
"POINT(-65.50048 43.2532)",2001,2015,14,"4",11480
"POINT(-77.229936 44.152886)",1992,2018,26,"27",13603
"POINT(-64.710486 46.475972)",2004,2010,6,"7",15230
"POINT(-71.71751 46.41901)",2016,2021,5,"4",16166
"POINT(-51.3 44.3)",1968,1986,18,"19",13214
"POINT(-64.861867 46.665292)",2011,2014,3,"2",15667
"POINT(-82.517801 41.970728)",2002,2003,1,"2",15027
"POINT(-77.072526 44.096244)",1992,2018,26,"27",13984
"POINT(-59.348941 46.441917)",1982,1987,5,"4",11085
"POINT(-62.44628 43.89789)",1974,2008,34,"35",14388
"POINT(-68.871657 43.27657)",1982,2014,32,"33",14623
"POINT(-70.87637 46.85767)",2016,2021,5,"5",15962
"POINT(-58.635512 47.364248)",1975,1994,19,"9",10719
"POINT(-71.735654 43.931506)",2012,2014,2,"3",13089
"POINT(-71.71751 46.41901)",2016,2021,5,"5",16135
"POINT(-72.47958 46.88236)",2016,2021,5,"2",15965
"POINT(-53.864595 53.910492)",1981,1993,12,"5",11007
"POINT(-64.646046 47.789535)",2011,2014,3,"2",15367
"POINT(-66.75 46.5)",1970,2014,44,"45",12774
"POINT(-77.229936 44.152886)",1992,2018,26,"27",13662
"POINT(-65.50048 43.2532)",1995,2016,21,"22",12212
"POINT(-70.87637 46.85767)",2016,2020,4,"5",16073
"POINT(-52.121122 50.695322)",1978,1991,13,"9",11114
"POINT(-63.510533 45.059112)",1968,2014,46,"47",11153
"POINT(-56.422124 48.62557)",1960,2013,53,"54",15841
"POINT(-61.56738 44.19795)",1996,2008,12,"9",12400
"POINT(-55.225157 50.548819)",1968,2011,43,"9",12968
"POINT(-61.56738 44.19795)",1970,1981,11,"12",11416
"POINT(-61.56738 44.19795)",1974,1981,7,"6",12516
"POINT(-65.029957 47.777114)",2011,2014,3,"2",15304
"POINT(-73.93333 40.15)",1995,1999,4,"5",15864
"POINT(-61.56738 44.19795)",1995,2009,14,"7",12145
"POINT(-76.06 44.055)",1998,2013,15,"7",13055
"POINT(-69.041914 40.95268)",1967,2014,47,"48",14617
"POINT(-78.733333 50.2)",2001,2009,8,"9",12928
"POINT(-82.517801 41.970728)",2002,2003,1,"2",15016
"POINT(-61.56738 44.19795)",1995,2016,21,"22",11849
"POINT(-65.50048 43.2532)",1995,2005,10,"2",11372
"POINT(-63 47)",1971,2016,45,"46",10060
"POINT(-61.56738 44.19795)",1995,2016,21,"22",11315
"POINT(-77.072526 44.096244)",1992,2018,26,"27",14026
"POINT(-72 54)",1970,2014,44,"45",12677
"POINT(-70.87637 46.85767)",2016,2021,5,"6",15937
"POINT(-56.766309 56.477534)",1978,1991,13,"7",10917
"POINT(-61.56738 44.19795)",1970,1981,11,"12",12305
"POINT(-51 49.15)",1980,1996,16,"17",13304
"POINT(-74.381869 45.160229)",1984,2008,24,"5",14038
"POINT(-66.291594 46.666605)",1970,2014,44,"45",12808
"POINT(-65.50048 43.2532)",1970,1981,11,"10",11475
"POINT(-61.56738 44.19795)",1983,1993,10,"6",11328
"POINT(-61.56738 44.19795)",1995,2016,21,"18",11654
"POINT(-63.758716 46.383956)",2011,2014,3,"2",15238
"POINT(-56.383301 46.711721)",1984,1995,11,"12",14893
"POINT(-72.82857 45.04889)",2016,2021,5,"3",15884
"POINT(-65.50048 43.2532)",1996,2015,19,"10",12132
"POINT(-61.181309 42.866877)",1970,1994,24,"17",10951
"POINT(-78.291582 43.944964)",1987,2016,29,"30",14003
"POINT(-65.50048 43.2532)",1995,2016,21,"22",12103
"POINT(-57.690888 43.437611)",1972,1987,15,"12",10943
"POINT(-64.554866 46.218937)",2005,2007,2,"2",15480
"POINT(-64.554866 46.218937)",2004,2010,6,"7",15634
"POINT(-63 47)",1981,2016,35,"33",10036
"POINT(-66.11572 44.8247)",1997,2012,15,"16",14577
"POINT(-72.47958 46.88236)",2016,2021,5,"2",16211
"POINT(-65.50048 43.2532)",1995,2016,21,"22",11954
"POINT(-61.56738 44.19795)",1995,2016,21,"22",11495
"POINT(-57 46.06667)",1996,2012,16,"16",11211
"POINT(-72.88129 46.69751)",2016,2021,5,"6",16083
"POINT(-61.56738 44.19795)",1982,1994,12,"13",11738
"POINT(-73.354283 51.290389)",1970,2014,44,"45",11151
"POINT(-68.871657 43.27657)",1982,2014,32,"33",14735
"POINT(-63 47)",1971,2016,45,"45",10030
"POINT(-68.871657 43.27657)",1982,2014,32,"33",14567
"POINT(-57.690888 43.437611)",1970,1994,24,"25",10250
"POINT(-63 47)",1978,1990,12,"13",13309
"POINT(-62.067902 49.652037)",1972,1989,17,"4",10502
"POINT(-63.510533 45.059112)",1968,2014,46,"47",11149
"POINT(-59 49)",1986,2010,24,"24",11260
"POINT(-77.72313 43.99472)",2008,2015,7,"2",13814
"POINT(-55.995809 46.034584)",1970,1994,24,"24",11057
"POINT(-57.690888 43.437611)",1970,1994,24,"25",10569
"POINT(-64.56477 46.273319)",2011,2014,3,"2",15286
"POINT(-66.11572 44.8247)",1997,2012,15,"16",14521
"POINT(-61.56738 44.19795)",1995,2016,21,"20",12277
"POINT(-69.666667 48.15)",1994,2005,11,"12",12899
"POINT(-62.547863 46.172776)",2011,2014,3,"2",15307
"POINT(-65.50048 43.2532)",1970,1981,11,"12",11933
"POINT(-62.067902 49.652037)",1984,1990,6,"3",10670
"POINT(-64.861867 46.665292)",2006,2010,4,"5",15792
"POINT(-61.56738 44.19795)",1982,1994,12,"12",11513
"POINT(-82.517801 41.970728)",2002,2003,1,"2",15008
"POINT(-72.47958 46.88236)",2016,2021,5,"2",16128
"POINT(-86 50)",1970,2014,44,"45",12678
"POINT(-62.11238 46.383134)",2004,2010,6,"7",15131
"POINT(-56.383301 46.711721)",1999,2010,11,"10",14889
"POINT(-81.550191 45.214983)",2004,2015,11,"12",12925
"POINT(-79.85068 43.28331)",2008,2014,6,"2",13856
"POINT(-52.782383 44.683779)",1976,1994,18,"16",10819
"POINT(-55.995809 46.034584)",1970,1994,24,"20",10817
"POINT(-57.854 44.91813)",1970,2002,32,"33",14181
"POINT(-72.88129 46.69751)",2020,2021,1,"2",16014
"POINT(-66.291594 46.666605)",1970,2014,44,"45",12885
"POINT(-78.56511 67.35631)",1988,1989,1,"2",12988
"POINT(-61.25 45.75)",1996,1997,1,"2",14098
"POINT(-76.06 44.055)",1976,2013,37,"35",13052
"POINT(-61.56738 44.19795)",1970,1981,11,"9",11651
"POINT(-79.85068 43.28331)",2006,2014,8,"5",13832
"POINT(-72 54)",1970,2014,44,"45",12657
"POINT(-56.766309 56.477534)",1978,1988,10,"5",11115
"POINT(-83.05 42.033333)",1975,2004,29,"29",12918
"POINT(-62.067902 49.652037)",1972,1991,19,"9",10693
"POINT(-63.728047 47.637685)",1970,1994,24,"25",10405
"POINT(-65.098835 42.729563)",1983,1987,4,"4",10420
"POINT(-72 54)",1970,2014,44,"45",12692
"POINT(-65.3 43)",1962,1988,26,"27",13387
"POINT(-79.61666 43.61666)",1975,1977,2,"3",11164
"POINT(-64.951922 46.75123)",2004,2010,6,"6",15056
"POINT(-65.50048 43.2532)",1982,1994,12,"13",12100
"POINT(-77.80861 43.698439)",1997,2012,15,"14",13486
"POINT(-66.214847 41.627502)",1980,1993,13,"10",10600
"POINT(-63 47)",1971,2016,45,"46",10050
"POINT(-75.23807 45.200085)",1995,2004,9,"10",10097
"POINT(-52.77293 47.262571)",1979,2001,22,"4",14811
"POINT(-69.666667 48.15)",1994,2004,10,"11",12906
"POINT(-82.517801 41.970728)",2002,2003,1,"2",15023
"POINT(-84.499722 49.25)",1995,2006,11,"12",9959
"POINT(-69.041914 40.95268)",1969,2008,39,"40",14728
"POINT(-76.06 44.055)",1976,2016,40,"41",13063
"POINT(-61.56738 44.19795)",1995,2016,21,"22",11433
"POINT(-74.018383 39.10066)",1968,2011,43,"44",14706
"POINT(-72.47958 46.88236)",2016,2021,5,"2",16039
"POINT(-61.56738 44.19795)",1982,1994,12,"13",11415
"POINT(-77.072526 44.096244)",1992,2018,26,"27",13963
"POINT(-62.067902 49.652037)",1973,1994,21,"20",10759
"POINT(-71.71751 46.41901)",2018,2021,3,"2",16156
"POINT(-63.802767 46.136433)",2005,2010,5,"5",15707
"POINT(-72.82857 45.04889)",2016,2019,3,"2",15974
"POINT(-72.88129 46.69751)",2016,2021,5,"5",15995
"POINT(-65.3 43)",1962,1988,26,"27",13282
"POINT(-64.573724 46.34102)",2004,2010,6,"7",15647
"POINT(-65.50048 43.2532)",1995,2016,21,"22",11492
"POINT(-77.396957 43.50608)",1997,2018,21,"22",13905
"POINT(-52.150931 52.188158)",1978,1994,16,"17",13124
"POINT(-61.56738 44.19795)",1995,2009,14,"7",12412
"POINT(-65.50048 43.2532)",1995,2016,21,"21",11917
"POINT(-61.181309 42.866877)",1980,1989,9,"4",10522
"POINT(-65.50048 43.2532)",1982,1994,12,"13",11897
"POINT(-63.165833 46.420833)",2011,2014,3,"2",15145
"POINT(-50.28156 53.257559)",1977,1994,17,"17",14842
"POINT(-74.018383 39.10066)",1971,2016,45,"46",14704
"POINT(-61.56738 44.19795)",1995,2016,21,"22",11905
"POINT(-77.547686 43.947746)",1992,2018,26,"27",13965
"POINT(-58.635512 47.364248)",1973,1994,21,"18",10851
"POINT(-62.03333 48.9)",1990,2012,22,"23",11261
"POINT(-65.50048 43.2532)",1996,2012,16,"8",11703
"POINT(-68.615921 41.275324)",1950,2016,66,"67",14684
"POINT(-63.66575 45.8547)",2006,2010,4,"2",15564
"POINT(-66.865556 45.95)",1988,2003,15,"16",11174
"POINT(-65.50048 43.2532)",1995,2016,21,"22",12155
"POINT(-61.56738 44.19795)",1970,1981,11,"10",11634
"POINT(-63 47)",1972,2016,44,"36",10044
"POINT(-77.547686 43.947746)",1992,2018,26,"27",13944
"POINT(-61.56738 44.19795)",1995,2016,21,"22",11392
"POINT(-68.615921 41.275324)",1963,2005,42,"43",14199
"POINT(-63.165833 46.420833)",2011,2014,3,"2",15387
"POINT(-65.50048 43.2532)",1995,2016,21,"8",12093
"POINT(-74.381869 45.160229)",1984,2018,34,"17",13634
"POINT(-61.56738 44.19795)",1970,1981,11,"12",12270
"POINT(-74.381869 45.160229)",2012,2018,6,"4",13914
"POINT(-61.56738 44.19795)",1991,1993,2,"3",11887
"POINT(-62.90725 46.058533)",2011,2014,3,"2",15175
"POINT(-62.11238 46.383134)",2004,2010,6,"2",15066
"POINT(-63.446958 46.46855)",2004,2005,1,"2",15544
"POINT(-77.396957 43.50608)",1997,2018,21,"22",13990
"POINT(-52.782383 44.683779)",1977,1994,17,"6",10315
"POINT(-66.291594 46.666605)",1970,2014,44,"45",12702
"POINT(-67 41)",1950,1998,48,"49",13217
"POINT(-77.396957 43.50608)",1997,2018,21,"22",13927
"POINT(-72.47958 46.88236)",2016,2021,5,"2",16020
"POINT(-65.50048 43.2532)",1995,2016,21,"22",12007
"POINT(-69.666667 48.15)",1994,2004,10,"11",12895
"POINT(-68.3 43.3)",2007,2014,7,"8",14414
"POINT(-74.381869 45.160229)",1984,2018,34,"17",13754
"POINT(-65.3 43)",1970,1997,27,"28",13386
"POINT(-63.66575 45.8547)",2004,2010,6,"7",15768
"POINT(-52.121122 50.695322)",1970,1994,24,"22",10465
"POINT(-79.361398 43.62142)",2006,2012,6,"4",13574
"POINT(-86 50)",1970,2014,44,"45",12668
"POINT(-72.47958 46.88236)",2016,2021,5,"2",16065
"POINT(-58.93 43.84)",1988,2011,23,"18",15851
"POINT(-65.50048 43.2532)",1970,1981,11,"12",11728
"POINT(-76.56667 44.3)",1982,1997,15,"16",15837
"POINT(-63 47)",1987,2016,29,"24",10041
"POINT(-71.093778 40.671798)",1982,2012,30,"31",14226
"POINT(-61.56738 44.19795)",1982,1994,12,"13",11682
"POINT(-65.50048 43.2532)",1970,1981,11,"11",12000
"POINT(-61.56738 44.19795)",1970,1981,11,"7",11478
"POINT(-63 47)",1972,2016,44,"21",10007
"POINT(-61.56738 44.19795)",1982,1994,12,"13",11835
"POINT(-61.181309 42.866877)",1974,1991,17,"5",11107
"POINT(-76.06 44.055)",1979,2014,35,"23",13062
"POINT(-62.74132 45.67583)",2004,2010,6,"6",15794
"POINT(-49.956886 45.114711)",1972,1993,21,"13",10683
"POINT(-82.517801 41.970728)",2002,2003,1,"2",15003
"POINT(-65.50048 43.2532)",1970,1981,11,"12",12230
"POINT(-72.88129 46.69751)",2016,2021,5,"6",16173
"POINT(-62.11238 46.383134)",2011,2014,3,"2",15623
"POINT(-64.861867 46.665292)",2006,2010,4,"5",15323
"POINT(-65.098835 42.729563)",1971,1993,22,"11",11117
"POINT(-63.126667 46.235)",1998,1999,1,"2",14978
"POINT(-65.50048 43.2532)",1996,2016,20,"15",12250
"POINT(-63.427139 46.193528)",2008,2010,2,"3",15336
"POINT(-77.22225 44.149251)",2001,2015,14,"14",13801
"POINT(-65.50048 43.2532)",1995,2005,10,"2",11906
"POINT(-58.635512 47.364248)",1985,1994,9,"6",10898
"POINT(-57.854 44.91813)",1970,2002,32,"33",14206
"POINT(-68.871657 43.27657)",1982,2014,32,"33",14763
"POINT(-64.965766 47.341712)",2004,2010,6,"7",15394
"POINT(-63.802767 46.136433)",2005,2010,5,"5",15097
"POINT(-69.666667 48.15)",1994,2004,10,"11",12904
"POINT(-52.757812 52.054271)",1995,2009,14,"15",14861
"POINT(-63.728047 47.637685)",1987,1991,4,"3",10523
"POINT(-69.041914 40.95268)",1984,2016,32,"33",14531
"POINT(-64.573724 46.34102)",2004,2010,6,"7",15224
"POINT(-61.181309 42.866877)",1970,1994,24,"25",10203
"POINT(-56.766309 56.477534)",1977,1991,14,"8",10930
"POINT(-60.749351 53.563249)",1975,2013,38,"3",15843
"POINT(-65.562778 46.995278)",2005,2009,4,"2",15720
"POINT(-77.229936 44.152886)",1992,2018,26,"27",13664
"POINT(-71.71751 46.41901)",2016,2021,5,"5",15887
"POINT(-72.82857 45.04889)",2016,2021,5,"3",16235
"POINT(-68.615921 41.275324)",1963,2016,53,"54",14568
"POINT(-77.072526 44.096244)",1992,2018,26,"27",13733
"POINT(-61.56738 44.19795)",1982,1994,12,"6",12641
"POINT(-63 47)",1978,1990,12,"13",13142
"POINT(-50.521046 49.772834)",1975,2006,31,"32",14562
"POINT(-72.88129 46.69751)",2016,2020,4,"5",16090
"POINT(-61.56738 44.19795)",1995,2016,21,"20",12544
"POINT(-53.172992 49.757443)",1981,1994,13,"14",11288
"POINT(-74.381869 45.160229)",1984,2008,24,"5",13912
"POINT(-62.74132 45.67583)",2004,2010,6,"7",15083
"POINT(-82.517801 41.970728)",2002,2003,1,"2",15001
"POINT(-79.0275 38.57111)",1974,1976,2,"3",12975
"POINT(-72.88129 46.69751)",2016,2021,5,"5",16129
"POINT(-65.50048 43.2532)",2000,2015,15,"14",11581
"POINT(-61.56738 44.19795)",1995,2015,20,"12",12162
"POINT(-53.864595 53.910492)",1973,1994,21,"15",10426
"POINT(-48.319336 48.138699)",1975,1982,7,"8",14905
"POINT(-63.2 42)",1973,1986,13,"14",13412
"POINT(-63.427139 46.193528)",2008,2010,2,"3",15532
"POINT(-57.05 51)",1971,1995,24,"25",13421
"POINT(-47.89333 50.44083)",1983,2018,35,"36",14115
"POINT(-64.965766 47.341712)",2011,2014,3,"2",15660
"POINT(-84.499722 49.25)",1995,2005,10,"11",9965
"POINT(-65.031944 45.616667)",1995,1996,1,"2",9939
"POINT(-69.041914 40.95268)",1969,2008,39,"40",14644
"POINT(-65.098835 42.729563)",1985,1987,2,"3",11120
"POINT(-68.615921 41.275324)",1963,2009,46,"47",14457
"POINT(-52.121122 50.695322)",1973,1994,21,"7",10736
"POINT(-55.39306 45.80582)",1972,1983,11,"12",13083
"POINT(-65.562778 46.995278)",2004,2010,6,"7",15408
"POINT(-59.348941 46.441917)",1974,1994,20,"20",10846
"POINT(-63.66575 45.8547)",2004,2010,6,"7",15403
"POINT(-52.757812 52.054271)",1977,1994,17,"18",14863
"POINT(-66.291594 46.666605)",1970,2014,44,"45",12817
"POINT(-61.71722 48.33722)",1990,2000,10,"11",11195
"POINT(-74.018383 39.10066)",1973,2002,29,"30",14396
"POINT(-71.71751 46.41901)",2016,2021,5,"4",16072
"POINT(-63 47)",1973,2016,43,"36",10020
"POINT(-57.93333 48.95)",1994,1997,3,"4",13102
"POINT(-48.319336 48.138699)",1985,1995,10,"11",14903
"POINT(-70.87637 46.85767)",2016,2021,5,"6",15959
"POINT(-65.50048 43.2532)",1995,2016,21,"22",11832
"POINT(-50.457342 50.936521)",1993,1994,1,"2",14849
"POINT(-74.018383 39.10066)",1967,2005,38,"39",14319
"POINT(-77.547686 43.947746)",1992,2018,26,"27",13631
"POINT(-72.82857 45.04889)",2016,2021,5,"3",16004
"POINT(-62.44628 43.89789)",1974,2008,34,"35",14413
"POINT(-63.902612 46.237205)",2001,2006,5,"6",10086
"POINT(-64.710486 46.475972)",2004,2010,6,"5",15550
"POINT(-61.56738 44.19795)",1995,2016,21,"22",12289
"POINT(-59 49.25)",1965,2017,52,"53",14640
"POINT(-86 50)",1970,2014,44,"45",12795
"POINT(-65.50048 43.2532)",1995,2016,21,"22",12142
"POINT(-63.728047 47.637685)",1974,1994,20,"20",10847
"POINT(-65.50048 43.2532)",1982,1994,12,"13",11994
"POINT(-77.80861 43.698439)",1997,2012,15,"14",13459
"POINT(-65.50048 43.2532)",1995,2016,21,"22",11875
"POINT(-61.56738 44.19795)",1987,1990,3,"2",11452
"POINT(-74.381869 45.160229)",1994,2018,24,"4",14016
"POINT(-59.348941 46.441917)",1982,1990,8,"5",10944
"POINT(-61.56738 44.19795)",1982,1984,2,"2",11542
"POINT(-55.995809 46.034584)",1970,1994,24,"18",10990
"POINT(-56.383301 46.711721)",1972,1982,10,"11",14968
"POINT(-66.46191 46.56531)",2010,2015,5,"2",12937
"POINT(-71.759018 43.932686)",2012,2014,2,"3",13091
"POINT(-65.50048 43.2532)",1982,1994,12,"13",11698
"POINT(-70.87637 46.85767)",2016,2021,5,"6",16031
"POINT(-59.348941 46.441917)",1970,1994,24,"19",11097
"POINT(-61.455567 46.07815)",2004,2010,6,"7",15219
"POINT(-64.554866 46.218937)",2011,2014,3,"2",15368
"POINT(-70.87637 46.85767)",2018,2019,1,"2",15985
"POINT(-63.06152 46.75491)",1970,2011,41,"42",14357
"POINT(-64.965766 47.341712)",2011,2014,3,"2",15438
"POINT(-63 47)",1978,2009,31,"32",11235
"POINT(-53.864595 53.910492)",1976,1984,8,"3",10528
"POINT(-65.098835 42.729563)",1970,1994,24,"25",11011
"POINT(-63.728047 47.637685)",1974,1994,20,"11",10633
"POINT(-65.50048 43.2532)",1995,2016,21,"20",11543
"POINT(-50.3 44.3)",1965,1986,21,"22",13200
"POINT(-55.995809 46.034584)",1983,1994,11,"9",10482
"POINT(-69.041914 40.95268)",1969,2008,39,"40",14672
"POINT(-65.50048 43.2532)",1982,1994,12,"13",12261
"POINT(-69 43)",1967,1989,22,"23",13293
"POINT(-63 47)",1978,1990,12,"13",13268
"POINT(-78.523333 45.595278)",1952,1995,43,"43",11276
"POINT(-65.50048 43.2532)",1995,2016,21,"20",12077
"POINT(-68.615921 41.275324)",1950,2016,66,"67",14628
"POINT(-71.093778 40.671798)",1982,2012,30,"31",14276
"POINT(-52.782383 44.683779)",1978,1983,5,"5",10343
"POINT(-67.86528 44.36722)",1968,1998,30,"26",9947
"POINT(-63 45)",1970,2014,44,"45",12672
"POINT(-74.381869 45.160229)",1984,2018,34,"10",13992
"POINT(-71.093778 40.671798)",1989,2016,27,"28",14685
"POINT(-61.56738 44.19795)",1995,2016,21,"22",11823
"POINT(-71.71751 46.41901)",2016,2019,3,"3",16057
"POINT(-57.690888 43.437611)",1983,1989,6,"4",10377
"POINT(-61.56738 44.19795)",1995,2016,21,"10",12609
"POINT(-65.50048 43.2532)",1995,2016,21,"22",12574
"POINT(-59.822611 42.550438)",1970,1980,10,"8",11253
"POINT(-61.56738 44.19795)",1970,1981,11,"12",12408
"POINT(-61.56738 44.19795)",1982,1994,12,"13",12593
"POINT(-64.951922 46.75123)",2004,2010,6,"7",15478
"POINT(-57.690888 43.437611)",1979,1990,11,"6",10939
"POINT(-61.56738 44.19795)",1995,2016,21,"19",11813
"POINT(-70.87637 46.85767)",2019,2021,2,"3",15932
"POINT(-84.52551 50.219196)",2016,2017,1,"2",14988
"POINT(-77.547686 43.947746)",1992,2018,26,"27",13625
"POINT(-79.361398 43.62142)",2006,2012,6,"4",13465
"POINT(-77.229936 44.152886)",1992,2018,26,"27",13645
"POINT(-64.710486 46.475972)",2011,2014,3,"2",15753
"POINT(-62.067902 49.652037)",1978,1994,16,"13",10474
"POINT(-65.50048 43.2532)",1995,2016,21,"22",11485
"POINT(-75.53 35.224444)",1992,1993,1,"2",12655
"POINT(-65.50048 43.2532)",1970,1981,11,"11",11877
"POINT(-77.396972 43.506083)",1997,2018,21,"9",13988
"POINT(-62.511072 46.018891)",2011,2014,3,"2",15249
"POINT(-61.56738 44.19795)",1995,2016,21,"21",12604
"POINT(-61.181309 42.866877)",1972,1994,22,"19",10804
"POINT(-79.361398 43.62142)",2006,2012,6,"4",13491
"POINT(-81.10944 44.42389)",1992,1994,2,"3",13009
"POINT(-65.50048 43.2532)",1982,1994,12,"13",12387
"POINT(-74.381869 45.160229)",1990,2018,28,"3",14015
"POINT(-77.547686 43.947746)",1992,2018,26,"27",13688
"POINT(-63.213505 46.253599)",2009,2011,2,"3",12933
"POINT(-62.511072 46.018891)",2005,2010,5,"5",15641
"POINT(-74.381869 45.160229)",2002,2016,14,"3",14012
"POINT(-53.183333 49.75)",2000,2003,3,"3",11180
"POINT(-61.56738 44.19795)",1973,1980,7,"4",11453
"POINT(-64.573724 46.34102)",2011,2014,3,"2",15167
"POINT(-63.888896 46.512101)",2009,2010,1,"2",15410
"POINT(-63.902612 46.237205)",2001,2003,2,"3",10073
"POINT(-67.5 47.58333)",1971,1981,10,"11",13127
"POINT(-74.931907 47.16858)",1972,2012,40,"32",11298
"POINT(-64.56477 46.273319)",2011,2014,3,"2",15242
"POINT(-64.34864 48.90011)",1995,2016,21,"2",14830
"POINT(-52.121122 50.695322)",1970,1994,24,"22",10353
"POINT(-65.50048 43.2532)",1970,1981,11,"12",11854
"POINT(-61.56738 44.19795)",1973,1980,7,"4",12521
"POINT(-65.50048 43.2532)",1983,1994,11,"4",12180
"POINT(-61.56738 44.19795)",1970,1981,11,"9",12054
"POINT(-77.229936 44.152886)",1992,2018,26,"27",13600
"POINT(-79.361398 43.62142)",2006,2012,6,"4",13542
"POINT(-53.864595 53.910492)",1971,1981,10,"3",11080
"POINT(-64.573724 46.34102)",2008,2009,1,"2",15695
"POINT(-75.688981 36.091782)",1988,2006,18,"13",13036
"POINT(-72.22 42.48)",2013,2014,1,"2",12735
"POINT(-63.446958 46.46855)",2007,2009,2,"3",15714
"POINT(-61.56738 44.19795)",1983,1993,10,"8",11786
"POINT(-69.041914 40.95268)",1967,2014,47,"48",14645
"POINT(-64.8083 47.67109)",2011,2014,3,"2",15736
"POINT(-61.56738 44.19795)",1982,1994,12,"12",11780
"POINT(-64.646046 47.789535)",2011,2014,3,"2",15254
"POINT(-82.517801 41.970728)",2002,2003,1,"2",15030
"POINT(-65.50048 43.2532)",1996,2016,20,"18",11540
"POINT(-65.50048 43.2532)",1970,1981,11,"11",11733
"POINT(-61.56738 44.19795)",1995,2016,21,"22",12624
"POINT(-63 47)",1971,2016,45,"46",10059
"POINT(-77.396957 43.50608)",1997,2018,21,"22",14011
"POINT(-79.361398 43.62142)",2006,2012,6,"4",13494
"POINT(-63.06152 46.75491)",1978,2018,40,"41",14578
"POINT(-72.47958 46.88236)",2016,2021,5,"2",15901
"POINT(-77.547686 43.947746)",1992,2018,26,"27",14049
"POINT(-63.728047 47.637685)",1970,1994,24,"25",10831
"POINT(-48.33984 44.59046)",1977,2000,23,"24",14337
"POINT(-53.864595 53.910492)",1973,1994,21,"21",10317
"POINT(-64.11454 46.1827)",2011,2014,3,"2",15261
"POINT(-63.2 42)",1973,1986,13,"14",13160
"POINT(-74.381869 45.160229)",1984,2018,34,"17",13695
"POINT(-71.71751 46.41901)",2016,2017,1,"2",15918
"POINT(-74.58861 36.44722)",1985,2014,29,"30",14632
"POINT(-73.107078 52.941847)",1970,2014,44,"45",12799
"POINT(-84.52551 50.219196)",2016,2017,1,"2",14997
"POINT(-61.181309 42.866877)",1971,1994,23,"9",11118
"POINT(-47.89333 50.44083)",1983,2018,35,"36",14265
"POINT(-56.766309 56.477534)",1978,1991,13,"5",10640
"POINT(-64.657552 47.746584)",2004,2010,6,"7",15515
"POINT(-58.635512 47.364248)",1971,1994,23,"22",10462
"POINT(-79.0275 38.571111)",1974,1979,5,"6",10067
"POINT(-72.82857 45.04889)",2016,2021,5,"3",16074
"POINT(-53.864595 53.910492)",1976,1994,18,"15",10639
"POINT(-60.79843 53.003392)",1974,2014,40,"41",12715
"POINT(-71.759018 43.932686)",2012,2014,2,"3",13090
"POINT(-79.361398 43.62142)",2006,2012,6,"4",13581
"POINT(-61.56738 44.19795)",1995,2016,21,"22",11909
"POINT(-65.63232 43.2452)",1980,2008,28,"29",14155
"POINT(-61.56738 44.19795)",1995,2016,21,"22",12208
"POINT(-64.126831 46.773778)",2004,2010,6,"7",15330
"POINT(-63.14804 46.23122)",2011,2014,3,"2",15187
"POINT(-61.56738 44.19795)",1996,2016,20,"14",12130
"POINT(-71.71751 46.41901)",2018,2020,2,"3",16061
"POINT(-61.56738 44.19795)",1982,1994,12,"12",12581
"POINT(-77.72313 43.99472)",2008,2015,7,"2",13893
"POINT(-52.121122 50.695322)",1970,1994,24,"18",10287
"POINT(-61.164851 45.857738)",1995,1997,2,"3",14081
"POINT(-76.794435 44.062208)",1992,2018,26,"27",13679
"POINT(-65.50048 43.2532)",1995,2016,21,"22",11439
"POINT(-61.56738 44.19795)",2010,2014,4,"2",12163
"POINT(-65.50048 43.2532)",1970,1975,5,"4",11669
"POINT(-70.87637 46.85767)",2016,2021,5,"6",16026
"POINT(-74.018383 39.10066)",1967,2005,38,"39",14244
"POINT(-63.06152 46.75491)",1978,2018,40,"41",14606
"POINT(-64.861867 46.665292)",2011,2014,3,"2",15442
"POINT(-64.951922 46.75123)",2006,2010,4,"3",15684
"POINT(-70.87637 46.85767)",2018,2021,3,"2",16068
"POINT(-50 43.083333)",1997,2011,14,"15",13443
"POINT(-65.3 43)",1970,1997,27,"28",13365
"POINT(-52.121122 50.695322)",1975,1989,14,"3",10656
"POINT(-69 43)",1967,1989,22,"23",13229
"POINT(-64.56477 46.273319)",2007,2010,3,"2",15789
"POINT(-61.56738 44.19795)",1996,2016,20,"11",11419
"POINT(-65.50048 43.2532)",1970,1981,11,"12",11975
"POINT(-61.56738 44.19795)",1970,1981,11,"12",12391
"POINT(-65.50048 43.2532)",1982,1994,12,"13",11412
"POINT(-74.381869 45.160229)",1990,2018,28,"3",13910
"POINT(-70.87637 46.85767)",2016,2021,5,"6",16094
"POINT(-61.56738 44.19795)",1982,1994,12,"13",12071
"POINT(-82.81667 42.16667)",1992,1994,2,"3",13006
"POINT(-66.214847 41.627502)",1980,1993,13,"10",10975
"POINT(-61.181309 42.866877)",1970,1994,24,"25",10164
"POINT(-63.888896 46.512101)",2009,2010,1,"2",15087
"POINT(-65.57426 46.98624)",2008,2010,2,"3",15121
"POINT(-65.50048 43.2532)",1983,1991,8,"6",12045
"POINT(-82.517801 41.970728)",2002,2003,1,"2",15002
"POINT(-64.965766 47.341712)",2006,2010,4,"5",15683
"POINT(-58.452138 49.69674)",1971,1994,23,"23",11056
"POINT(-69 43)",1967,1989,22,"23",13208
"POINT(-72.82857 45.04889)",2019,2021,2,"2",15917
"POINT(-74.381869 45.160229)",1984,2018,34,"17",13693
"POINT(-65.50048 43.2532)",1982,1994,12,"13",11562
"POINT(-63 47)",1978,1990,12,"13",13267
"POINT(-63 47)",1977,2016,39,"24",10005
"POINT(-61.1985 45.9668)",1996,1997,1,"2",14080
"POINT(-61.56738 44.19795)",1982,1994,12,"13",12037
"POINT(-75.348421 39.407679)",1961,2013,52,"53",11127
"POINT(-72.88129 46.69751)",2016,2021,5,"2",15942
"POINT(-75.517 45.419)",1983,2001,18,"2",14827
"POINT(-71.093778 40.671798)",1967,2005,38,"39",14375
"POINT(-86 50)",1970,2014,44,"45",12842
"POINT(-63.728047 47.637685)",1970,1994,24,"25",10746
"POINT(-74.381869 45.160229)",1998,2016,18,"5",13930
"POINT(-52.782383 44.683779)",1970,1994,24,"22",10622
"POINT(-65.50048 43.2532)",1970,1981,11,"12",12330
"POINT(-65.50048 43.2532)",1970,1981,11,"12",12028
"POINT(-79.361398 43.62142)",2006,2012,6,"4",13579
"POINT(-61.56738 44.19795)",1970,1978,8,"3",12135
"POINT(-77.547686 43.947746)",1992,2012,20,"21",13457
"POINT(-67.064717 44.266029)",1972,1994,22,"13",10769
"POINT(-63 47)",1971,2016,45,"46",10039
"POINT(-72.88129 46.69751)",2016,2019,3,"3",16086
"POINT(-61.181309 42.866877)",1970,1983,13,"7",10446
"POINT(-61.56738 44.19795)",1970,1981,11,"12",12124
"POINT(-63.446958 46.46855)",2004,2010,6,"7",15756
"POINT(-77.229936 44.152886)",1992,2018,26,"27",13763
"POINT(-65.6491 47.6175)",2009,2011,2,"2",15551
"POINT(-56 49)",1990,2010,20,"21",11219
"POINT(-72.88129 46.69751)",2016,2021,5,"5",15899
"POINT(-65.50048 43.2532)",1995,2016,21,"22",11766
"POINT(-61.56738 44.19795)",1991,1993,2,"3",12421
"POINT(-65.098835 42.729563)",1979,1983,4,"3",10518
"POINT(-68.615921 41.275324)",1950,2016,66,"67",14544
"POINT(-77.396957 43.50608)",1997,2018,21,"22",13947
"POINT(-72 54)",1970,2014,44,"45",12757
"POINT(-65.562778 46.995278)",2004,2010,6,"6",15589
"POINT(-71 41)",1977,1994,17,"17",14834
"POINT(-65.50048 43.2532)",1970,1978,8,"6",11647
"POINT(-61.56738 44.19795)",1995,2016,21,"22",12570
"POINT(-63 47)",1971,2016,45,"46",10025
"POINT(-61.56738 44.19795)",1970,1981,11,"12",11799
"POINT(-73.43806 38.53306)",1963,2009,46,"47",14418
"POINT(-63.739472 45.85055)",2007,2009,2,"3",15791
"POINT(-68.615921 41.275324)",1950,2007,57,"58",14431
"POINT(-56.088564 46.878456)",1978,2001,23,"2",14809
"POINT(-62.650653 47.394909)",1952,2012,60,"60",11291
"POINT(-65.50048 43.2532)",1995,2016,21,"22",12170
"POINT(-63.66575 45.8547)",2011,2014,3,"2",15370
"POINT(-70.87637 46.85767)",2016,2021,5,"6",16202
"POINT(-53.864595 53.910492)",1974,1994,20,"19",10579
"POINT(-83.05 42.033333)",1975,2004,29,"29",12905
"POINT(-71.71751 46.41901)",2016,2021,5,"2",16227
"POINT(-72.82857 45.04889)",2016,2021,5,"3",16199
"POINT(-61.56738 44.19795)",1995,2009,14,"7",11344
"POINT(-65.50048 43.2532)",1982,1994,12,"13",11955
"POINT(-61.56738 44.19795)",1995,2016,21,"22",12635
"POINT(-66.214847 41.627502)",1977,1993,16,"12",10145
"POINT(-52.782383 44.683779)",1970,1994,24,"23",10763
"POINT(-61.455567 46.07815)",2004,2010,6,"7",15528
"POINT(-79.58333 42.85)",1985,1994,9,"10",14820
"POINT(-62.11238 46.383134)",2011,2014,3,"2",15770
"POINT(-65.50048 43.2532)",1995,2016,21,"22",11506
"POINT(-63.802767 46.136433)",2011,2014,3,"2",15781
"POINT(-64.8083 47.67109)",2009,2010,1,"2",15081
"POINT(-57.771263 49.761184)",1971,2011,40,"41",11305
"POINT(-68.3 43.3)",2007,2014,7,"8",14470
"POINT(-65.50048 43.2532)",1983,1994,11,"4",11913
"POINT(-68.526458 40.575228)",1982,2016,34,"35",14535
"POINT(-64.861867 46.665292)",2006,2010,4,"4",15585
"POINT(-64.861867 46.665292)",2007,2010,3,"4",15453
"POINT(-70.87637 46.85767)",2019,2021,2,"3",15955
"POINT(-61 47)",1967,2010,43,"42",11267
"POINT(-65.50048 43.2532)",1970,1981,11,"11",12144
"POINT(-65.50048 43.2532)",1970,1981,11,"12",12295
"POINT(-72 54)",1970,2014,44,"45",12844
"POINT(-61.56738 44.19795)",1982,1994,12,"13",11949
"POINT(-58.74 49.68361)",1987,2011,24,"25",11207
"POINT(-59.853639 59.286076)",1978,1988,10,"5",10366
"POINT(-63.739472 45.85055)",2005,2009,4,"5",15401
"POINT(-53.183871 49.756652)",1951,1984,33,"13",13120
"POINT(-61.017433 46.6243)",2011,2014,3,"2",15471
"POINT(-61.017433 46.6243)",2008,2010,2,"3",15598
"POINT(-61.181309 42.866877)",1974,1984,10,"3",10726
"POINT(-65.50048 43.2532)",1974,1978,4,"2",11838
"POINT(-61.56738 44.19795)",1982,1994,12,"12",12047
"POINT(-65.50048 43.2532)",1995,2016,21,"22",11341
"POINT(-68.526458 40.575228)",1982,2016,34,"35",14759
"POINT(-59.853639 59.286076)",1978,1987,9,"3",10904
"POINT(-65.3 43)",1962,1988,26,"27",13303
"POINT(-52.121122 50.695322)",1970,1994,24,"19",10442
"POINT(-61.56738 44.19795)",1970,1981,11,"12",11969
"POINT(-61.1985 45.9668)",1996,1997,1,"2",14096
"POINT(-67.064717 44.266029)",1971,1990,19,"9",10976
"POINT(-65.50048 43.2532)",1970,1981,11,"11",11364
"POINT(-61.56738 44.19795)",1982,1994,12,"13",12304
"POINT(-62.90725 46.058533)",2005,2010,5,"4",15639
"POINT(-74.381869 45.160229)",1998,2010,12,"2",14039
"POINT(-48.319336 48.138699)",1975,1982,7,"8",14880
"POINT(-61.56738 44.19795)",1970,1981,11,"8",12118
"POINT(-50.370609 48.414273)",1977,2000,23,"24",14218
"POINT(-57.690888 43.437611)",1982,1992,10,"4",11108
"POINT(-61.56738 44.19795)",1995,2016,21,"22",12535
"POINT(-61.56738 44.19795)",1970,1981,11,"12",11396
"POINT(-61.56738 44.19795)",1970,1981,11,"12",11357
"POINT(-63 47)",1971,2011,40,"40",11213
"POINT(-74.42417 45.11111)",1974,2018,44,"44",12976
"POINT(-61.56738 44.19795)",1984,1992,8,"7",11910
"POINT(-81.87611 45.625)",1950,1983,33,"34",13317
"POINT(-69.041914 40.95268)",1984,2016,32,"33",14755
"POINT(-61.56738 44.19795)",1982,1994,12,"13",11606
"POINT(-62.067902 49.652037)",1972,1994,22,"21",10459
"POINT(-71.71751 46.41901)",2016,2021,5,"6",16005
"POINT(-77.229936 44.152886)",1992,2018,26,"27",13661
"POINT(-52.782383 44.683779)",1970,1994,24,"24",10654
"POINT(-65.50048 43.2532)",1985,2016,31,"7",11827
"POINT(-55.995809 46.034584)",1974,1991,17,"5",10968
"POINT(-65.50048 43.2532)",1985,2016,31,"7",12094
"POINT(-64.7 43.374167)",1983,2008,25,"26",11244
"POINT(-63.165833 46.420833)",2011,2014,3,"2",15752
"POINT(-61.56738 44.19795)",1970,1980,10,"6",11916
"POINT(-61.56738 44.19795)",1982,1994,12,"13",11633
"POINT(-63.06152 46.75491)",1978,2018,40,"41",14803
"POINT(-77.072526 44.096244)",1992,2018,26,"27",13673
"POINT(-61.56738 44.19795)",1995,2010,15,"11",11625
"POINT(-77.22225 44.149251)",2001,2015,14,"14",13588
"POINT(-73.148804 47.931066)",1965,2013,48,"49",11126
"POINT(-65.50048 43.2532)",1970,1981,11,"12",11940
"POINT(-61.181309 42.866877)",1970,1994,24,"25",10647
"POINT(-74.381869 45.160229)",1994,2018,24,"4",13911
"POINT(-61.56738 44.19795)",1997,2016,19,"13",11861
"POINT(-77.99944 43.75)",1978,1985,7,"8",13430
"POINT(-61.56738 44.19795)",1982,1994,12,"6",11693
"POINT(-48.33984 44.59046)",1977,2000,23,"24",14312
"POINT(-75.149444 39.05)",1982,2006,24,"23",11188
"POINT(-61.56738 44.19795)",1995,2016,21,"22",11723
"POINT(-79.361398 43.62142)",2006,2012,6,"4",13577
"POINT(-52.150931 52.188158)",1995,2004,9,"10",13125
"POINT(-58.635512 47.364248)",1983,1994,11,"12",10883
"POINT(-55.995809 46.034584)",1974,1987,13,"3",10449
"POINT(-61.56738 44.19795)",1970,1981,11,"12",12626
"POINT(-77.229936 44.152886)",1992,2012,20,"21",13584
"POINT(-73.107078 52.941847)",1970,2014,44,"45",12876
"POINT(-79.361398 43.62142)",2006,2012,6,"4",13554
"POINT(-59.348941 46.441917)",1989,1991,2,"3",11040
"POINT(-79.87106 44.866139)",1993,2007,14,"15",13024
"POINT(-65.50048 43.2532)",1982,1994,12,"13",11363
"POINT(-77.072526 44.096244)",1992,2018,26,"27",14005
"POINT(-61.56738 44.19795)",1982,1994,12,"13",11691
"POINT(-79.361398 43.62142)",2006,2012,6,"4",13493
"POINT(-69.666667 48.15)",1994,2005,11,"12",12910
"POINT(-65.50048 43.2532)",2011,2013,2,"2",12284
"POINT(-65.50048 43.2532)",1995,2016,21,"22",11726
"POINT(-72.88129 46.69751)",2020,2021,1,"2",16155
"POINT(-65.50048 43.2532)",1970,1981,11,"11",11466
"POINT(-61.56738 44.19795)",1982,1994,12,"13",12418
"POINT(-63 47)",1978,1990,12,"13",13289
"POINT(-63.802767 46.136433)",2005,2009,4,"5",15050
"POINT(-62.511072 46.018891)",2005,2010,5,"6",15114
"POINT(-62.067902 49.652037)",1972,1988,16,"8",10282
"POINT(-62.11238 46.383134)",2011,2014,3,"2",15197
"POINT(-58.452138 49.69674)",1971,1989,18,"4",10708
"POINT(-65.50048 43.2532)",1995,2016,21,"22",11430
"POINT(-71.71751 46.41901)",2016,2021,5,"6",15873
"POINT(-74.381869 45.160229)",2000,2016,16,"5",14002
"POINT(-67 43)",1970,2010,40,"41",14164
"POINT(-74.381869 45.160229)",1994,2018,24,"4",13974
"POINT(-65.50048 43.2532)",1995,2016,21,"22",11318
"POINT(-83.05 42.033333)",1976,2004,28,"28",12901
"POINT(-77.72313 43.99472)",2008,2015,7,"2",13901
"POINT(-52.782383 44.683779)",1970,1994,24,"23",10926
"POINT(-65.50048 43.2532)",1982,1994,12,"13",12471
"POINT(-61.56738 44.19795)",1986,1988,2,"2",11482
"POINT(-66.75 46.5)",1970,2014,44,"45",12664
"POINT(-61.56738 44.19795)",1982,1994,12,"13",11339
"POINT(-65.50048 43.2532)",1995,2016,21,"22",11465
"POINT(-63.902612 46.237205)",2001,2006,5,"6",10080
"POINT(-52.782383 44.683779)",1970,1994,24,"22",10257
"POINT(-71.093778 40.671798)",1982,2012,30,"31",14201
"POINT(-84.499722 49.25)",1995,2005,10,"11",9971
"POINT(-68.526458 40.575228)",1964,2016,52,"53",14630
"POINT(-68.615921 41.275324)",1963,2005,42,"43",14299
"POINT(-77.547686 43.947746)",1992,2018,26,"27",13748
"POINT(-65.50048 43.2532)",1970,1981,11,"12",12416
"POINT(-61.56738 44.19795)",1995,2016,21,"22",11690
"POINT(-57.690888 43.437611)",1970,1993,23,"24",10586
"POINT(-74.58861 36.44722)",1985,2014,29,"30",14604
"POINT(-61.56738 44.19795)",1982,1994,12,"6",11960
"POINT(-50.521046 49.772834)",1975,2006,31,"32",14534
"POINT(-64.11454 46.1827)",2009,2010,1,"2",15096
"POINT(-65.50048 43.2532)",1986,1988,2,"2",11984
"POINT(-67 43)",1970,2010,40,"41",14139
"POINT(-61.56738 44.19795)",1970,1981,11,"12",11874
"POINT(-71.71751 46.41901)",2016,2021,5,"6",16189
"POINT(-71.71751 46.41901)",2016,2021,5,"6",16030
"POINT(-63.66575 45.8547)",2006,2010,4,"4",15793
"POINT(-72.88129 46.69751)",2016,2020,4,"2",16131
"POINT(-67.064717 44.266029)",1971,1993,22,"10",10826
"POINT(-68.526458 40.575228)",1982,2016,34,"35",14619
"POINT(-65.50048 43.2532)",1982,1994,12,"13",12622
"POINT(-62.90725 46.058533)",2005,2010,5,"6",15082
"POINT(-59.348941 46.441917)",1977,1991,14,"4",10979
"POINT(-79.85068 43.28331)",2006,2015,9,"5",13902
"POINT(-84.499722 49.25)",1995,2005,10,"11",9974
"POINT(-65.098835 42.729563)",1972,1993,21,"4",10813
"POINT(-61.56738 44.19795)",1988,1994,6,"3",11333
"POINT(-52.782383 44.683779)",1970,1994,24,"12",11063
"POINT(-71.71751 46.41901)",2016,2021,5,"4",15893
"POINT(-62.814813 46.967671)",1981,2009,28,"29",14107
"POINT(-65.63232 43.2452)",1970,2010,40,"41",14136
"POINT(-76.794435 44.062208)",1992,2012,20,"21",13454
"POINT(-61.56738 44.19795)",1995,2016,21,"22",11588
"POINT(-86 50)",1970,2014,44,"45",12838
"POINT(-66.214847 41.627502)",1980,1993,13,"11",11009
"POINT(-63 43)",1965,2006,41,"42",11229
"POINT(-63.902612 46.237205)",2001,2006,5,"6",10093
"POINT(-61.28389 47.21917)",1987,2011,24,"25",11205
"POINT(-77.59299 44.01301)",2001,2015,14,"3",13900
"POINT(-52.782383 44.683779)",1975,1990,15,"7",10811
"POINT(-71.71751 46.41901)",2018,2021,3,"4",15889
"POINT(-64.861867 46.665292)",2006,2010,4,"5",15079
"POINT(-55.3 46)",1959,1993,34,"35",13180
"POINT(-77.229936 44.152886)",1992,2018,26,"27",13712
"POINT(-77.072526 44.096244)",1992,2018,26,"27",13609
"POINT(-82.81667 42.16667)",1992,1994,2,"3",13007
"POINT(-61.56738 44.19795)",1970,1980,10,"6",12450
"POINT(-61.896111 47.392778)",1972,2005,33,"27",14113
"POINT(-65.50048 43.2532)",1982,1994,12,"13",11665
"POINT(-77.229936 44.152886)",1992,2018,26,"27",13652
"POINT(-65.562778 46.995278)",2011,2014,3,"2",15177
"POINT(-67.5 40.4)",1955,1987,32,"33",13131
"POINT(-61.181309 42.866877)",1970,1983,13,"10",10794
"POINT(-47.89333 50.44083)",1983,2018,35,"36",14165
"POINT(-74.381869 45.160229)",1984,2008,24,"5",14017
"POINT(-78.733333 50.2)",2001,2009,8,"9",12927
"POINT(-61.017433 46.6243)",2011,2014,3,"2",15183
"POINT(-61.56738 44.19795)",2010,2014,4,"2",11629
"POINT(-61.181309 42.866877)",1970,1993,23,"24",10585
"POINT(-70.87637 46.85767)",2017,2021,4,"5",16180
"POINT(-80.41667 42.57944)",1988,1991,3,"4",12983
"POINT(-61.56738 44.19795)",1995,2016,21,"22",11926
"POINT(-58.452138 49.69674)",1973,1992,19,"7",10967
"POINT(-57.05 51)",1971,1995,24,"25",13190
"POINT(-69.041914 40.95268)",1984,2016,32,"33",14671
"POINT(-70.87637 46.85767)",2016,2021,5,"6",16041
"POINT(-64.965766 47.341712)",2011,2014,3,"2",15178
"POINT(-64.554866 46.218937)",2011,2014,3,"2",15612
"POINT(-61.56738 44.19795)",1995,2016,21,"22",11899
"POINT(-77.547686 43.947746)",1992,2018,26,"27",14028
"POINT(-77.229936 44.152886)",1992,2018,26,"27",13767
"POINT(-86 50)",1970,2014,44,"45",12857
"POINT(-61.181309 42.866877)",1970,1994,24,"20",10294
"POINT(-63.06152 46.75491)",1970,2011,41,"42",14132
"POINT(-71.736244 43.961609)",2012,2018,6,"5",13095
"POINT(-69.041914 40.95268)",1967,2014,47,"48",14589
"POINT(-83.05 42.033333)",1975,2004,29,"29",12916
"POINT(-65.50048 43.2532)",1995,2016,21,"22",12087
"POINT(-65.50048 43.2532)",1970,1981,11,"12",12069
"POINT(-77.547686 43.947746)",1992,2012,20,"21",13537
"POINT(-65.50048 43.2532)",1982,1994,12,"13",12222
"POINT(-68.615921 41.275324)",1963,2005,42,"43",14272
"POINT(-65.562778 46.995278)",2006,2010,4,"3",15690
"POINT(-62.735984 45.290147)",1970,2014,44,"45",12877
"POINT(-65.50048 43.2532)",1982,1992,10,"6",12378
"POINT(-63.728047 47.637685)",1973,1994,21,"12",11015
"POINT(-61.56738 44.19795)",1970,1981,11,"12",11618
"POINT(-61.87121 45.68314)",2011,2014,3,"2",15755
"POINT(-59 44.1)",1976,1990,14,"15",13153
"POINT(-79.038014 58.750352)",1985,2008,23,"5",11254
"POINT(-61.56738 44.19795)",1982,1994,12,"13",12102
"POINT(-58.635512 47.364248)",1971,1994,23,"22",10539
"POINT(-77.547686 43.947746)",1992,2018,26,"27",13627
"POINT(-68.526458 40.575228)",1982,2016,34,"35",14479
"POINT(-65.50048 43.2532)",1970,1981,11,"12",12481
"POINT(-61.56738 44.19795)",1995,2016,21,"22",12224
"POINT(-74.381869 45.160229)",1984,2016,32,"16",13756
"POINT(-61.56738 44.19795)",1970,1981,11,"12",12353
"POINT(-65.50048 43.2532)",1995,2016,21,"16",12485
"POINT(-68.615921 41.275324)",1950,2007,57,"58",14459
"POINT(-65.50048 43.2532)",1996,2016,20,"15",11449
"POINT(-69 43)",1967,1989,22,"23",13398
"POINT(-65.50048 43.2532)",1995,2016,21,"22",11820
"POINT(-69.041914 40.95268)",1969,2008,39,"40",14756
"POINT(-61.455567 46.07815)",2004,2010,6,"6",15465
"POINT(-65.50048 43.2532)",1996,2012,16,"8",12504
"POINT(-65.50097 43.15568)",1988,2009,21,"22",14106
"POINT(-51 49.15)",1980,1996,16,"17",13388
"POINT(-70.87637 46.85767)",2016,2021,5,"6",16062
"POINT(-55.995809 46.034584)",1970,1994,24,"24",11076
"POINT(-52.121122 50.695322)",1970,1994,24,"16",10327
"POINT(-61.56738 44.19795)",1982,1994,12,"13",11900
"POINT(-61.56738 44.19795)",1973,1980,7,"4",11720
"POINT(-52.121122 50.695322)",1978,1994,16,"8",10378
"POINT(-57.854 44.91813)",1970,2002,32,"33",14256
"POINT(-60.3 44.1)",1967,1990,23,"24",13227
"POINT(-63.446958 46.46855)",2011,2014,3,"2",15726
"POINT(-72.88129 46.69751)",2016,2021,5,"6",16198
"POINT(-67.064717 44.266029)",1971,1994,23,"12",10613
"POINT(-59.348941 46.441917)",1970,1994,24,"25",10508
"POINT(-63.802767 46.136433)",2005,2010,5,"5",15574
"POINT(-65.50048 43.2532)",1982,1992,10,"6",12645
"POINT(-52.121122 50.695322)",1970,1994,24,"23",10213
"POINT(-67.064717 44.266029)",1971,1994,23,"8",10292
"POINT(-65.50048 43.2532)",1998,2009,11,"7",11505
"POINT(-61.56738 44.19795)",1995,2016,21,"22",11729
"POINT(-61.56738 44.19795)",1996,2016,20,"11",11686
"POINT(-79.361398 43.62142)",2006,2012,6,"4",13450
"POINT(-52.757812 52.054271)",1995,2009,14,"15",14909
"POINT(-64.209251 44.537006)",1985,2012,27,"19",11300
"POINT(-63.466588 46.348013)",1969,2014,45,"46",11152
"POINT(-63.427139 46.193528)",2011,2014,3,"2",15382
"POINT(-61.56738 44.19795)",1982,1994,12,"13",12625
"POINT(-72.34455 47.18667)",2001,2013,12,"6",11166
"POINT(-61.164851 45.857738)",1995,1997,2,"3",14089
"POINT(-67.064717 44.266029)",1971,1994,23,"17",10400
"POINT(-60.3 44.1)",1967,1990,23,"24",13396
"POINT(-52.782383 44.683779)",1970,1993,23,"14",10682
"POINT(-83.6375 56.42278)",1985,2005,20,"5",13449
"POINT(-78.523333 45.595278)",1952,1995,43,"43",12954
"POINT(-64.873712 47.473463)",2005,2010,5,"6",15269
"POINT(-63.728047 47.637685)",1970,1994,24,"25",10170
"POINT(-61.56738 44.19795)",1983,1993,10,"8",12053
"POINT(-85.58269 49.249515)",1981,1984,3,"4",15820
"POINT(-65.50048 43.2532)",2001,2014,13,"7",12192
"POINT(-50.28156 53.257559)",1995,2009,14,"15",14839
"POINT(-68.615921 41.275324)",1963,2009,46,"47",14625
"POINT(-63 47)",1997,2016,19,"13",10055
"POINT(-52.121122 50.695322)",1987,1994,7,"6",10335
"POINT(-63.06152 46.75491)",1978,2018,40,"41",14663
"POINT(-74.018383 39.10066)",1982,2015,33,"34",14789
"POINT(-61.87121 45.68314)",2011,2014,3,"2",15680
"POINT(-61.164851 45.857738)",1995,1997,2,"3",14065
"POINT(-65.50048 43.2532)",1982,1994,12,"13",12590
"POINT(-64.573724 46.34102)",2004,2010,6,"7",15093
"POINT(-67.5 40.4)",1955,1987,32,"33",13341
"POINT(-61.56738 44.19795)",1995,2016,21,"22",11700
"POINT(-65.50048 43.2532)",1995,2016,21,"16",12218
"POINT(-74.58861 36.44722)",1985,2014,29,"30",14660
"POINT(-57.690888 43.437611)",1970,1994,24,"25",10907
"POINT(-72.82857 45.04889)",2016,2019,3,"2",15910
"POINT(-49.956886 45.114711)",1973,1981,8,"3",10241
"POINT(-65.50048 43.2532)",1995,2016,21,"22",11641
"POINT(-59 49.25)",1965,2017,52,"53",14527
"POINT(-76.06 44.055)",1976,2015,39,"39",13042
"POINT(-63.06152 46.75491)",1978,2018,40,"41",14691
"POINT(-79.37806 44.73333)",1980,1987,7,"8",13192
"POINT(-64.11454 46.1827)",2011,2014,3,"2",15620
"POINT(-61.56738 44.19795)",1995,2016,21,"22",11980
"POINT(-79.85068 43.28331)",2006,2015,9,"6",13847
"POINT(-74.381869 45.160229)",1984,2016,32,"15",13701
"POINT(-63 47)",1984,2012,28,"25",10056
"POINT(-61.56738 44.19795)",1995,2016,21,"22",12493
"POINT(-68.526458 40.575228)",1964,2016,52,"53",14434
"POINT(-86 50)",1970,2014,44,"45",12759
"POINT(-56.766309 56.477534)",1978,1991,13,"5",10427
"POINT(-52.121122 50.695322)",1982,1994,12,"6",10419
"POINT(-58.93 43.48)",1988,2011,23,"18",15847
"POINT(-84.499722 49.25)",1995,2004,9,"9",9958
"POINT(-65.50048 43.2532)",1970,1981,11,"12",11947
"POINT(-84.267975 45.465968)",2014,2016,2,"3",10070
"POINT(-67.5 40.4)",1955,1987,32,"33",13215
"POINT(-62.86667 48.82361)",1987,2011,24,"25",11203
"POINT(-61.87121 45.68314)",2004,2010,6,"7",15102
"POINT(-60.3 44.1)",1967,1990,23,"24",13374
"POINT(-62.735984 45.290147)",1970,2014,44,"45",12713
"POINT(-79.85068 43.28331)",2014,2015,1,"2",13815
"POINT(-69 43)",1967,1989,22,"23",13145
"POINT(-61.56738 44.19795)",1995,2016,21,"22",12491
"POINT(-57.690888 43.437611)",1970,1994,24,"24",10952
"POINT(-79.361398 43.62142)",2006,2012,6,"4",13502
"POINT(-57.690888 43.437611)",1970,1994,24,"25",10744
"POINT(-67 43)",1970,2010,40,"41",14239
"POINT(-61.56738 44.19795)",1995,2016,21,"20",12575
"POINT(-64.646046 47.789535)",2004,2010,6,"7",15119
"POINT(-65.50048 43.2532)",1995,2016,21,"22",11533
"POINT(-65.50048 43.2532)",1982,1994,12,"13",12088
"POINT(-82.517801 41.970728)",2002,2003,1,"2",15017
"POINT(-65.50048 43.2532)",1995,2016,21,"22",12300
"POINT(-84.499722 49.25)",1995,2004,9,"9",9969
"POINT(-52.757812 52.054271)",1977,1994,17,"18",14934
"POINT(-64.56477 46.273319)",2007,2009,2,"2",15764
"POINT(-65.50048 43.2532)",1970,1981,11,"12",11461
"POINT(-61.56738 44.19795)",1970,1978,8,"3",11601
"POINT(-61.56738 44.19795)",1985,1994,9,"4",11775
"POINT(-68.21667 44.35)",1957,2002,45,"3",10000
"POINT(-79.85068 43.28331)",2006,2015,9,"6",13864
"POINT(-78.416667 45.583333)",1988,1998,10,"11",12941
"POINT(-63.728047 47.637685)",1982,1992,10,"5",10382
"POINT(-79.361398 43.62142)",2006,2012,6,"4",13559
"POINT(-52.121122 50.695322)",1971,1994,23,"12",10485
"POINT(-72 54)",1970,2014,44,"45",12696
"POINT(-52.121122 50.695322)",1978,1994,16,"12",10375
"POINT(-52.757812 52.054271)",1977,1994,17,"18",14959
"POINT(-79.85068 43.28331)",2006,2010,4,"2",13824
"POINT(-62.511072 46.018891)",2005,2010,5,"6",15084
"POINT(-72.82857 45.04889)",2016,2019,3,"2",16067
"POINT(-69.041914 40.95268)",1967,2014,47,"48",14701
"POINT(-76.794435 44.062208)",1992,2018,26,"27",13922
"POINT(-72 40)",1973,2016,43,"44",14585
"POINT(-61.56738 44.19795)",1996,2016,20,"14",11596
"POINT(-55.39306 45.80582)",1996,2013,17,"18",13080
"POINT(-62.547863 46.172776)",2011,2014,3,"2",15386
"POINT(-65.50048 43.2532)",1995,2016,21,"8",12627
"POINT(-52.782383 44.683779)",1978,1992,14,"3",10549
"POINT(-68.615921 41.275324)",1950,2016,66,"67",14516
"POINT(-61.56738 44.19795)",1971,1974,3,"2",11765
"POINT(-61.56738 44.19795)",1983,1993,10,"8",11922
"POINT(-76.06 44.055)",1980,1985,5,"3",13061
"POINT(-66.75 46.5)",1970,2014,44,"45",12837
"POINT(-63 47)",1978,1990,12,"13",13225
"POINT(-77.954487 62.570058)",1980,2004,24,"8",12972
"POINT(-84.499722 49.25)",1995,2005,10,"11",9962
"POINT(-53.75 49.36667)",2000,2003,3,"3",11176
"POINT(-61.56738 44.19795)",1995,2016,21,"22",11451
"POINT(-84.499722 49.25)",1995,2005,10,"11",9985
"POINT(-64.56477 46.273319)",2007,2010,3,"4",15207
"POINT(-68.3 43.3)",2007,2014,7,"8",14750
"POINT(-63.06152 46.75491)",1978,2018,40,"41",14550
"POINT(-62.067902 49.652037)",1973,1994,21,"21",10437
"POINT(-72.88129 46.69751)",2019,2021,2,"3",16013
"POINT(-65.50048 43.2532)",1995,2016,21,"19",11510
"POINT(-59.822611 42.550438)",1970,1980,10,"8",11250
"POINT(-64.126831 46.773778)",2005,2010,5,"6",15691
"POINT(-59 49.25)",1965,2017,52,"53",14583
"POINT(-57.690888 43.437611)",1972,1994,22,"22",10867
"POINT(-77.72313 43.99472)",2008,2015,7,"2",13897
"POINT(-71.71751 46.41901)",2017,2020,3,"3",16149
"POINT(-64.554866 46.218937)",2004,2010,6,"7",15790
"POINT(-52.121122 50.695322)",1971,1978,7,"5",10550
"POINT(-68.526458 40.575228)",1964,2016,52,"53",14770
"POINT(-65.50048 43.2532)",2000,2015,15,"14",11314
"POINT(-52.121122 50.695322)",1970,1994,24,"24",10176
"POINT(-61.56738 44.19795)",1995,2016,21,"22",11957
"POINT(-64.56477 46.273319)",2007,2010,3,"4",15633
"POINT(-53.37158 51.46769)",1979,2011,32,"33",14637
"POINT(-70.9375 43.01472)",1989,1991,2,"3",9952
"POINT(-48.319336 48.138699)",1975,1982,7,"8",14856
"POINT(-64.965766 47.341712)",2004,2010,6,"7",15202
"POINT(-65.50048 43.2532)",2006,2014,8,"3",11539
"POINT(-61.56738 44.19795)",1995,2016,21,"22",11407
"POINT(-85.903961 48.289722)",2011,2017,6,"2",14111
"POINT(-63.394728 46.363106)",2001,2002,1,"2",15858
"POINT(-65.50048 43.2532)",1983,1991,8,"6",12579
"POINT(-61.56738 44.19795)",1995,2016,21,"22",12166
"POINT(-61.56738 44.19795)",1987,1990,3,"2",12253
"POINT(-72.88129 46.69751)",2016,2021,5,"6",16177
"POINT(-65.562778 46.995278)",2004,2010,6,"5",15566
"POINT(-62.511072 46.018891)",2011,2014,3,"2",15672
"POINT(-64.11454 46.1827)",2009,2010,1,"2",15126
"POINT(-64.965766 47.341712)",2004,2010,6,"7",15071
"POINT(-65.50048 43.2532)",1995,2016,21,"22",11697
"POINT(-71.093778 40.671798)",1968,2006,38,"39",14377
"POINT(-79.146454 46.634905)",2002,2004,2,"3",10107
"POINT(-58.452138 49.69674)",1984,1994,10,"6",10717
"POINT(-65.50048 43.2532)",1995,2016,21,"22",12231
"POINT(-67 41)",1950,1998,48,"49",13280
"POINT(-52.757812 52.054271)",1977,1994,17,"18",14911
"POINT(-64.873712 47.473463)",2009,2010,1,"2",15554
"POINT(-61.87121 45.68314)",2011,2014,3,"2",15267
"POINT(-74.381869 45.160229)",2006,2018,12,"7",13978
"POINT(-61.87121 45.68314)",2011,2014,3,"2",15474
"POINT(-65.50048 43.2532)",1970,1981,11,"12",11535
"POINT(-49.956886 45.114711)",1972,1993,21,"16",10752
"POINT(-65.50048 43.2532)",1996,2014,18,"4",11575
"POINT(-77.547686 43.947746)",1992,2018,26,"27",13687
"POINT(-59.348941 46.441917)",1971,1994,23,"6",10478
"POINT(-77.072526 44.096244)",1992,2018,26,"27",13615
"POINT(-65.50048 43.2532)",1982,1994,12,"13",12241
"POINT(-74.58861 36.44722)",1985,2014,29,"30",14716
"POINT(-64.710486 46.475972)",2004,2009,5,"6",15491
"POINT(-61.87121 45.68314)",2004,2010,6,"7",15132
"POINT(-82.517801 41.970728)",2002,2003,1,"2",15009
"POINT(-62.067902 49.652037)",1973,1994,21,"18",10910
"POINT(-61.56738 44.19795)",1995,2016,21,"22",11563
"POINT(-65.50048 43.2532)",1970,1981,11,"12",11494
"POINT(-65.63232 43.2452)",1982,2006,24,"25",14216
"POINT(-62.067902 49.652037)",1985,1990,5,"4",10688
"POINT(-61.56738 44.19795)",1982,1994,12,"13",11958
"POINT(-84.583333 46.933333)",1983,1985,2,"3",13448
"POINT(-74.381869 45.160229)",1984,2014,30,"6",13938
"POINT(-61.56738 44.19795)",1995,2016,21,"22",12331
"POINT(-62.067902 49.652037)",1976,1994,18,"15",10634
"POINT(-56.383301 46.711721)",1972,1978,6,"7",14871
"POINT(-76.794435 44.062208)",1992,2018,26,"27",13734
"POINT(-63.427139 46.193528)",2008,2010,2,"3",15596
"POINT(-65.50048 43.2532)",1995,2005,10,"2",12440
"POINT(-57.690888 43.437611)",1979,1993,14,"14",11084
"POINT(-72 54)",1970,2014,44,"45",12765
"POINT(-77.22225 44.149251)",2001,2015,14,"14",13833
"POINT(-61.1985 45.9668)",1996,1997,1,"2",14072
"POINT(-55.995809 46.034584)",1970,1994,24,"24",10142
"POINT(-77.59299 44.01301)",2001,2015,14,"3",13840
"POINT(-55.616667 46.866667)",1974,2001,27,"5",14808
"POINT(-63 47)",1976,2013,37,"35",10013
"POINT(-65.50048 43.2532)",1995,2016,21,"22",12583
"POINT(-69 43)",1967,1989,22,"23",13313
"POINT(-72.88129 46.69751)",2016,2021,5,"6",16150
"POINT(-61.56738 44.19795)",1995,2016,21,"22",12090
"POINT(-74.58861 36.44722)",1981,2008,27,"28",14153
"POINT(-59.348941 46.441917)",1977,1992,15,"3",10714
"POINT(-53.37158 51.46769)",1979,2011,32,"33",14609
"POINT(-76.794435 44.062208)",1992,2018,26,"27",13943
"POINT(-77.072526 44.096244)",1992,2018,26,"27",13725
"POINT(-63.802767 46.136433)",2011,2014,3,"2",15385
"POINT(-77.396957 43.50608)",1997,2018,21,"22",13906
"POINT(-79.33917 44.43667)",1970,1971,1,"2",13096
"POINT(-69.041914 40.95268)",1969,2008,39,"40",14504
"POINT(-64.710486 46.475972)",2011,2014,3,"2",15622
"POINT(-79.37806 44.73333)",1980,1987,7,"8",13297
"POINT(-61.56738 44.19795)",1982,1994,12,"13",11701
"POINT(-67.5 40.4)",1955,1987,32,"33",13278
"POINT(-65.50048 43.2532)",1970,1981,11,"12",12405
"POINT(-59 49.25)",1965,2017,52,"53",14471
"POINT(-59.348941 46.441917)",1970,1994,24,"19",10295
"POINT(-65.50048 43.2532)",1970,1981,11,"12",12214
"POINT(-70.87637 46.85767)",2016,2017,1,"2",16213
"POINT(-65.50048 43.2532)",1995,2016,21,"22",11636
"POINT(-77.72313 43.99472)",2008,2015,7,"2",13861
"POINT(-61.56738 44.19795)",1995,2016,21,"22",12247
"POINT(-64.861867 46.665292)",2011,2014,3,"2",15244
"POINT(-64.657552 47.746584)",2011,2014,3,"2",15354
"POINT(-77.396957 43.50608)",1997,2018,21,"22",13948
"POINT(-68.871657 43.27657)",1985,2016,31,"32",14547
"POINT(-61.56738 44.19795)",1983,1993,10,"8",11388
"POINT(-49.956886 45.114711)",1973,1991,18,"9",11103
"POINT(-58.452138 49.69674)",1980,1993,13,"9",10475
"POINT(-65.50048 43.2532)",1982,1994,12,"13",12596
"POINT(-53.37158 51.46769)",1979,2011,32,"33",14581
"POINT(-63.902612 46.237205)",2001,2006,5,"6",10092
"POINT(-65.098835 42.729563)",1970,1994,24,"25",10977
"POINT(-71.71751 46.41901)",2018,2021,3,"4",15945
"POINT(-72.992232 46.96733)",1983,1997,14,"13",13069
"POINT(-61.56738 44.19795)",1997,2016,19,"20",11748
"POINT(-58.452138 49.69674)",1970,1994,24,"24",10679
"POINT(-61.56738 44.19795)",1995,2016,21,"22",11948
"POINT(-60.3 44.1)",1967,1990,23,"24",13290
"POINT(-62.28626 46.36766)",2011,2014,3,"2",15284
"POINT(-55.3 46)",1959,1993,34,"35",13222
"POINT(-74.58861 36.44722)",1985,2014,29,"30",14800
"POINT(-72 40)",1973,2016,43,"44",14697
"POINT(-57.690888 43.437611)",1971,1994,23,"22",10805
"POINT(-71.093778 40.671798)",1967,2005,38,"39",14300
"POINT(-61.181309 42.866877)",1970,1994,24,"25",10602
"POINT(-63.66575 45.8547)",2011,2014,3,"2",15668
"POINT(-69 43)",1967,1989,22,"23",13188
"POINT(-69 43)",1967,1989,22,"23",13167
"POINT(-55.995809 46.034584)",1970,1994,24,"24",10608
"POINT(-63 44)",1970,1985,15,"2",13115
"POINT(-65.63232 43.2452)",1970,2007,37,"38",14179
"POINT(-65.50048 43.2532)",1982,1992,10,"6",12111
"POINT(-61.56738 44.19795)",1970,1981,11,"12",11458
"POINT(-79.85068 43.28331)",2006,2010,4,"3",13882
"POINT(-72.82857 45.04889)",2016,2019,3,"2",15900
"POINT(-65.50048 43.2532)",1995,2016,21,"22",11602
"POINT(-74.018383 39.10066)",1982,2015,33,"34",14481
"POINT(-63.728047 47.637685)",1970,1994,24,"25",10650
"POINT(-64.965766 47.341712)",2011,2014,3,"2",15281
"POINT(-76.794435 44.062208)",1992,2018,26,"27",13985
"POINT(-82.134735 48.575324)",2002,2004,2,"3",10112
"POINT(-61.56738 44.19795)",1982,1993,11,"12",12427
"POINT(-65.50048 43.2532)",1982,1988,6,"5",12050
"POINT(-72.47958 46.88236)",2016,2021,5,"2",15994
"POINT(-79.633333 43.683333)",1978,1981,3,"4",13017
"POINT(-71.71751 46.41901)",2018,2019,1,"2",15941
"POINT(-68.526458 40.575228)",1964,2016,52,"53",14602
"POINT(-84.499722 49.25)",1995,2004,9,"9",9966
"POINT(-79.361398 43.62142)",2006,2012,6,"4",13552
"POINT(-74.58861 36.44722)",1981,2008,27,"28",14303
"POINT(-55.616667 46.866667)",1974,2001,27,"5",14813
"POINT(-79.37806 44.73333)",1980,1987,7,"8",13276
"POINT(-56.383301 46.711721)",1984,1995,11,"12",14965
"POINT(-71.80072 46.80408)",2017,2017,0,"2",16097
"POINT(-64.710486 46.475972)",2011,2014,3,"2",15701
"POINT(-65.098835 42.729563)",1979,1987,8,"4",10450
"POINT(-63 47)",1978,1990,12,"13",13288
"POINT(-59.348941 46.441917)",1970,1994,24,"25",10205
"POINT(-61.181309 42.866877)",1980,1986,6,"3",10984
"POINT(-74.018383 39.10066)",1973,2002,29,"30",14121
"POINT(-58.02978 50.13466)",1973,2003,30,"31",14267
"POINT(-65.50048 43.2532)",1999,2013,14,"3",12246
"POINT(-58.452138 49.69674)",1974,1994,20,"11",10349
"POINT(-84.499722 49.25)",1995,2006,11,"12",9973
"POINT(-63.728047 47.637685)",1970,1994,24,"22",10436
"POINT(-72.88129 46.69751)",2016,2018,2,"2",15934
"POINT(-72.47958 46.88236)",2016,2021,5,"2",16231
"POINT(-61.56738 44.19795)",1983,1994,11,"12",11818
"POINT(-51 49.15)",1980,1996,16,"17",13220
"POINT(-66.486934 47.136578)",2001,2002,1,"2",15857
"POINT(-69.666667 48.15)",1994,2004,10,"11",12893
"POINT(-79.361398 43.62142)",2006,2012,6,"4",13528
"POINT(-65.50048 43.2532)",2006,2014,8,"3",11806
"POINT(-48.319336 48.138699)",1996,2010,14,"15",14899
"POINT(-74.381869 45.160229)",2002,2016,14,"3",14033
"POINT(-73.107078 52.941847)",1970,2014,44,"45",12699
"POINT(-62.511072 46.018891)",2005,2010,5,"6",15215
"POINT(-61.56738 44.19795)",1982,1994,12,"9",12545
"POINT(-65.50048 43.2532)",1996,2016,20,"15",11983
"POINT(-64.126831 46.773778)",2011,2014,3,"2",15364
"POINT(-63 47)",1974,2010,36,"13",10011
"POINT(-64.873712 47.473463)",2005,2010,5,"4",15446
"POINT(-70.87637 46.85767)",2016,2021,5,"5",16082
"POINT(-72.47958 46.88236)",2016,2021,5,"2",16016
"POINT(-63 47)",1978,2010,32,"33",11233
"POINT(-65.50048 43.2532)",1982,1994,12,"12",12301
"POINT(-65.50048 43.2532)",1970,1981,11,"12",12063
"POINT(-67 41)",1950,1998,48,"49",13196
"POINT(-50.521046 49.772834)",1975,2006,31,"32",14478
"POINT(-59 44.1)",1976,1990,14,"15",13174
"POINT(-64.56477 46.273319)",2011,2014,3,"2",15501
"POINT(-65.50048 43.2532)",1972,1981,9,"9",11501
"POINT(-79.361398 43.62142)",2006,2012,6,"4",13570
"POINT(-64.573724 46.34102)",2005,2009,4,"2",15705
"POINT(-65.63232 43.2452)",1980,2008,28,"29",14305
"POINT(-66.35 44.75)",1983,2008,25,"26",11243
"POINT(-53.183333 49.75)",2000,2003,3,"3",11182
"POINT(-64.8083 47.67109)",2009,2010,1,"2",15325
"POINT(-79.85068 43.28331)",2006,2015,9,"6",13804
"POINT(-65.50048 43.2532)",1995,2016,21,"22",11903
"POINT(-64.8083 47.67109)",2009,2010,1,"2",15111
"POINT(-72.88129 46.69751)",2017,2019,2,"2",16208
"POINT(-75.363333 35.224444)",1992,1993,1,"2",12731
"POINT(-71.093778 40.671798)",1968,2006,38,"39",14302
"POINT(-61.56738 44.19795)",1982,1994,12,"13",11589
"POINT(-57.66043 53.1355)",1999,2014,15,"16",12737
"POINT(-65.50048 43.2532)",1990,1994,4,"2",11418
"POINT(-69.666667 48.15)",1994,2005,11,"12",12891
"POINT(-79.85068 43.28331)",2006,2015,9,"6",13818
"POINT(-65.50048 43.2532)",1995,2016,21,"17",11637
"POINT(-62.90725 46.058533)",2005,2010,5,"5",15326
"POINT(-84.499722 49.25)",1995,2005,10,"11",9991
"POINT(-79.361398 43.62142)",2006,2012,6,"4",13500
"POINT(-79.361398 43.62142)",2006,2012,6,"4",13576
"POINT(-61.56738 44.19795)",1989,1993,4,"2",12210
"POINT(-68.615921 41.275324)",1950,2016,66,"67",14572
"POINT(-65.098835 42.729563)",1971,1992,21,"7",10950
"POINT(-77.22225 44.149251)",2001,2015,14,"14",13794
"POINT(-79.85068 43.28331)",2006,2015,9,"3",13803
"POINT(-83.05 42.033333)",1975,2004,29,"29",12903
"POINT(-57.690888 43.437611)",1983,1994,11,"7",10422
"POINT(-65.57426 46.98624)",2009,2010,1,"2",15723
"POINT(-64.861867 46.665292)",2011,2014,3,"2",15357
"POINT(-73.107078 52.941847)",1970,2014,44,"45",12887
"POINT(-63.188167 45.760967)",2009,2010,1,"2",15314
"POINT(-53.864595 53.910492)",1971,1994,23,"23",10766
"POINT(-47.89333 50.44083)",1983,2018,35,"36",14340
"POINT(-63 47)",1978,1990,12,"13",13163
"POINT(-72 54)",1970,2014,44,"45",12684
"POINT(-63.728047 47.637685)",1978,1989,11,"3",10965
"POINT(-63.902612 46.237205)",2001,2006,5,"6",10075
"POINT(-68.526458 40.575228)",1982,2016,34,"35",14423
"POINT(-74.381869 45.160229)",2000,2016,16,"5",13960
"POINT(-59 44.1)",1976,1990,14,"15",13321
"POINT(-48.319336 48.138699)",1984,1995,11,"12",14901
"POINT(-70.87637 46.85767)",2016,2021,5,"5",16012
"POINT(-63.188167 45.760967)",2011,2014,3,"2",15236
"POINT(-52.757812 52.054271)",1977,1994,17,"18",14912
"POINT(-77.229936 44.152886)",1992,2018,26,"27",13655
"POINT(-63.14804 46.23122)",2011,2014,3,"2",15255
"POINT(-65.50048 43.2532)",1995,2016,21,"22",11553
"POINT(-65.098835 42.729563)",1975,1987,12,"6",10996
"POINT(-57.736944 49.689167)",1997,2007,10,"11",12998
"POINT(-73.93333 40.15)",1995,1999,4,"5",15866
"POINT(-61.56738 44.19795)",1995,2016,21,"19",12614
"POINT(-68.871657 43.27657)",1982,2014,32,"33",14539
"POINT(-73.167436 44.635128)",2009,2010,1,"2",11137
"POINT(-65.50048 43.2532)",1982,1994,12,"13",12056
"POINT(-65.50048 43.2532)",2001,2014,13,"7",11925
"POINT(-63 45)",1970,2012,42,"43",12747
"POINT(-52.121122 50.695322)",1970,1994,24,"23",10780
"POINT(-68.615921 41.275324)",1963,2005,42,"43",14198
"POINT(-65.63232 43.2452)",1970,2002,32,"33",14360
"POINT(-63.902612 46.237205)",2001,2003,2,"3",10078
"POINT(-50 43.083333)",2002,2011,9,"10",13445
"POINT(-64.710486 46.475972)",2011,2014,3,"2",15309
"POINT(-48.319336 48.138699)",1985,1995,10,"11",14927
"POINT(-61.56738 44.19795)",1995,2016,21,"22",12519
"POINT(-53.864595 53.910492)",1970,1994,24,"22",10916
"POINT(-69.666667 48.15)",1994,2005,11,"12",12919
"POINT(-62.511072 46.018891)",2005,2010,5,"6",15689
"POINT(-65.090012 44.451082)",1996,1997,1,"2",14100
"POINT(-61.56738 44.19795)",1982,1994,12,"13",11668
"POINT(-52.782383 44.683779)",1980,1994,14,"6",10923
"POINT(-65.562778 46.995278)",2011,2014,3,"2",15294
"POINT(-57.05 51)",1971,1995,24,"25",13316
"POINT(-77.072526 44.096244)",1992,2018,26,"27",13669
"POINT(-63.06152 46.75491)",1970,2011,41,"42",14332
"POINT(-64.573724 46.34102)",2004,2010,6,"7",15533
"POINT(-79.37806 44.73333)",1980,1987,7,"8",13150
"POINT(-63.2 42)",1973,1986,13,"14",13286
"POINT(-65.50048 43.2532)",1982,1994,12,"13",12294
"POINT(-50.3 44.3)",1965,1986,21,"22",13137
"POINT(-55.995809 46.034584)",1972,1993,21,"14",10897
"POINT(-65.63232 43.2452)",1970,2010,40,"41",14311
"POINT(-57.854 44.91813)",1970,2002,32,"33",14156
"POINT(-74.018383 39.10066)",1971,2016,45,"46",14452
"POINT(-77.229936 44.152886)",1992,2018,26,"27",13710
"POINT(-65.50048 43.2532)",1982,1994,12,"13",11679
"POINT(-56.766309 56.477534)",1986,1991,5,"3",10626
"POINT(-69 43)",1967,1989,22,"23",13166
"POINT(-65.50048 43.2532)",1970,1981,11,"12",11761
"POINT(-82.41667 42.55)",1985,1994,9,"10",14821
"POINT(-70.87637 46.85767)",2016,2017,1,"2",15903
"POINT(-64.710486 46.475972)",2004,2009,5,"3",15065
"POINT(-77.229936 44.152886)",1992,2018,26,"27",13606
"POINT(-62.916667 47.416667)",1971,2012,41,"42",15045
"POINT(-74.018383 39.10066)",1968,2011,43,"44",14650
"POINT(-55.995809 46.034584)",1970,1994,24,"19",10439
"POINT(-61.181309 42.866877)",1970,1994,24,"25",10978
"POINT(-68.526458 40.575228)",1964,2016,52,"53",14574
"POINT(-71.71751 46.41901)",2018,2020,2,"3",15980
"POINT(-65.090012 44.451082)",1996,1997,1,"2",14084
"POINT(-61.87121 45.68314)",2005,2006,1,"2",15577
"POINT(-72.82857 45.04889)",2016,2021,5,"3",16091
"POINT(-57.690888 43.437611)",1970,1994,24,"25",10188
"POINT(-77.547686 43.947746)",1992,2018,26,"27",13632
"POINT(-61.56738 44.19795)",1973,1980,7,"4",11987
"POINT(-63 47)",1997,2016,19,"13",10054
"POINT(-63.802767 46.136433)",2011,2014,3,"2",15306
"POINT(-58.635512 47.364248)",1977,1993,16,"11",10239
"POINT(-82.517801 41.970728)",2002,2003,1,"2",15035
"POINT(-77.072526 44.096244)",1992,2018,26,"27",13727
"POINT(-68.615921 41.275324)",1950,2007,57,"58",14487
"POINT(-62.74132 45.67583)",2004,2010,6,"7",15523
"POINT(-74.381869 45.160229)",1984,2018,34,"10",13908
"POINT(-65.098835 42.729563)",1970,1994,24,"25",10454
"POINT(-65.63232 43.2452)",1970,2007,37,"38",14379
"POINT(-77.22225 44.149251)",2001,2015,14,"14",13844
"POINT(-65.50048 43.2532)",1995,2016,21,"22",12589
"POINT(-74.490808 46.723904)",1983,1997,14,"15",13072
"POINT(-79.361398 43.62142)",2006,2012,6,"4",13546
"POINT(-74.58861 36.44722)",1981,2008,27,"28",14403
"POINT(-65.50048 43.2532)",1986,1988,2,"2",11717
"POINT(-58.635512 47.364248)",1971,1994,23,"18",10621
"POINT(-82.517801 41.970728)",2002,2003,1,"2",15014
"POINT(-65.50048 43.2532)",1996,2014,18,"4",11842
"POINT(-65.029957 47.777114)",2011,2014,3,"2",15180
"POINT(-61.56738 44.19795)",1970,1981,11,"12",12349
"POINT(-63.66575 45.8547)",2004,2010,6,"7",15080
"POINT(-63.016995 49.523121)",1983,2005,22,"23",14833
"POINT(-61.181309 42.866877)",1974,1987,13,"7",10451
"POINT(-61.87121 45.68314)",2004,2010,6,"7",15424
"POINT(-72.82857 45.04889)",2016,2021,5,"3",16165
"POINT(-61.87121 45.68314)",2005,2010,5,"6",15067
"POINT(-68.615921 41.275324)",1970,2016,46,"47",14458
"POINT(-63.802767 46.136433)",2011,2014,3,"2",15154
"POINT(-86 50)",1970,2014,44,"45",12794
"POINT(-64.657552 47.746584)",2004,2009,5,"3",15479
"POINT(-74.381869 45.160229)",1998,2016,18,"5",14035
"POINT(-65.63232 43.2452)",1980,2008,28,"29",14280
"POINT(-67.5 40.4)",1955,1987,32,"33",13320
"POINT(-64.657552 47.746584)",2004,2010,6,"7",15105
"POINT(-65.50048 43.2532)",1970,1981,11,"12",12509
"POINT(-61.25 45.75)",1996,1997,1,"2",14090
"POINT(-61.56738 44.19795)",1971,1981,10,"6",11389
"POINT(-64.554866 46.218937)",2004,2010,6,"7",15107
"POINT(-50.370609 48.414273)",1977,2000,23,"24",14293
"POINT(-61.56738 44.19795)",1970,1981,11,"12",11819
"POINT(-65.50048 43.2532)",1995,2016,21,"22",12553
"POINT(-64.861867 46.665292)",2006,2009,3,"2",15057
"POINT(-61.56738 44.19795)",1982,1994,12,"13",11408
"POINT(-59.348941 46.441917)",1979,1994,15,"11",10661
"POINT(-62.74132 45.67583)",2011,2014,3,"2",15292
"POINT(-64.965766 47.341712)",2011,2014,3,"2",15466
"POINT(-65.50048 43.2532)",1974,1978,4,"2",12105
"POINT(-64.710486 46.475972)",2006,2009,3,"2",15103
"POINT(-61.56738 44.19795)",1987,1990,3,"2",11719
"POINT(-61.56738 44.19795)",1995,2016,21,"22",11713
"POINT(-82.81667 42.16667)",1992,1994,2,"3",13013
"POINT(-76.794435 44.062208)",1992,2018,26,"27",13739
"POINT(-86 50)",1970,2014,44,"45",12663
"POINT(-65.50048 43.2532)",1995,2016,21,"22",12442
"POINT(-60.723669 46.803193)",2011,2013,2,"3",11132
"POINT(-68.526458 40.575228)",1982,2016,34,"35",14675
"POINT(-65.50048 43.2532)",2006,2014,8,"3",12340
"POINT(-55.3 46)",1959,1993,34,"35",13201
"POINT(-52.757812 52.054271)",1977,1994,17,"18",14935
"POINT(-65.50048 43.2532)",1982,1993,11,"4",12638
"POINT(-57.05 51)",1971,1995,24,"25",13274
"POINT(-70.87637 46.85767)",2016,2021,5,"6",16055
"POINT(-61.56738 44.19795)",1983,1993,10,"8",12456
"POINT(-61.56738 44.19795)",1995,2016,21,"22",12176
"POINT(-62.90725 46.058533)",2011,2014,3,"2",15360
"POINT(-49.956886 45.114711)",1971,1994,23,"13",10914
"POINT(-71.093778 40.671798)",1982,2012,30,"31",14126
"POINT(-61.56738 44.19795)",1970,1981,11,"12",12038
"POINT(-61.56738 44.19795)",1995,2016,21,"22",12373
"POINT(-85.992563 41.908235)",2011,2016,5,"6",13014
"POINT(-84.499722 49.25)",1995,2004,9,"9",9978
"POINT(-63 47)",1994,1998,4,"5",10024
"POINT(-86 50)",1970,2014,44,"45",12669
"POINT(-50 45)",1996,2013,17,"18",11307
"POINT(-64.269444 45.140278)",1976,2010,34,"14",13099
"POINT(-64.8083 47.67109)",2009,2010,1,"2",15521
"POINT(-55.995809 46.034584)",1970,1994,24,"24",10269
"POINT(-76.794435 44.062208)",1992,2018,26,"27",14048
"POINT(-62.067902 49.652037)",1984,1993,9,"9",10297
"POINT(-64.269444 45.140278)",1976,2010,34,"14",13098
"POINT(-61.1985 45.9668)",1996,1997,1,"2",14061
"POINT(-63.66575 45.8547)",2011,2014,3,"2",15614
"POINT(-65.50048 43.2532)",1995,2016,21,"19",11777
"POINT(-62.067902 49.652037)",1972,1990,18,"16",10606
"POINT(-82.448825 48.444828)",2002,2004,2,"3",10114
"POINT(-61.455567 46.07815)",2011,2014,3,"2",15616
"POINT(-55.995809 46.034584)",1970,1994,24,"17",10197
"POINT(-65.098835 42.729563)",1981,1985,4,"3",10489
"POINT(-62.11238 46.383134)",2004,2010,6,"7",15432
"POINT(-65.50048 43.2532)",1970,1981,11,"12",12057
"POINT(-65.3 43)",1950,1994,44,"45",13424
"POINT(-72.88129 46.69751)",2016,2021,5,"6",16186
"POINT(-47.315252 41.630515)",1996,2009,13,"11",14853
"POINT(-65.50048 43.2532)",1974,1978,4,"2",12372
"POINT(-64.710486 46.475972)",2011,2014,3,"2",15388
"POINT(-63.188167 45.760967)",2009,2010,1,"2",15270
"POINT(-78.5 45.58333)",1976,1989,13,"14",10120
"POINT(-61.181309 42.866877)",1970,1994,24,"25",10137
"POINT(-74.381869 45.160229)",1988,2014,26,"3",13979
"POINT(-61.56738 44.19795)",1995,2016,21,"22",11442
"POINT(-65.50048 43.2532)",1970,1981,11,"6",12585
"POINT(-65.562778 46.995278)",2011,2014,3,"2",15468
"POINT(-50 43.083333)",2001,2011,10,"11",13442
"POINT(-57.690888 43.437611)",1970,1994,24,"18",10553
"POINT(-63.165833 46.420833)",2011,2014,3,"2",15812
"POINT(-65.098835 42.729563)",1983,1987,4,"3",10318
"POINT(-61.56738 44.19795)",1995,2016,21,"22",12022
"POINT(-53.37158 51.46769)",1979,2011,32,"33",14693
"POINT(-85.58269 49.249515)",1981,1984,3,"4",15819
"POINT(-61.56738 44.19795)",1991,1993,2,"3",12154
"POINT(-60.79843 53.003392)",1980,2014,34,"35",12704
"POINT(-77.547686 43.947746)",1992,2018,26,"27",13683
"POINT(-49.956886 45.114711)",1970,1994,24,"22",10199
"POINT(-61.56738 44.19795)",1970,1981,11,"7",11745
"POINT(-65.50048 43.2532)",1995,2016,21,"22",11527
"POINT(-63.802767 46.136433)",2011,2014,3,"2",15148
"POINT(-61.56738 44.19795)",1982,1994,12,"13",12065
"POINT(-57.690888 43.437611)",1970,1994,24,"11",10477
"POINT(-59.853639 59.286076)",1978,1991,13,"6",10262
"POINT(-61.56738 44.19795)",1982,1994,12,"13",12269
"POINT(-73.107078 52.941847)",1970,2014,44,"45",12722
"POINT(-58.635512 47.364248)",1972,1994,22,"12",10810
"POINT(-61.56738 44.19795)",1995,2016,21,"22",12271
"POINT(-55.995809 46.034584)",1970,1994,24,"22",10761
"POINT(-64.710486 46.475972)",2004,2006,2,"3",15431
"POINT(-52.121122 50.695322)",1970,1994,24,"24",10516
"POINT(-63 47)",1971,2016,45,"42",10023
"POINT(-65.50048 43.2532)",1995,2016,21,"22",11993
"POINT(-84.499722 49.25)",1995,2004,9,"9",9955
"POINT(-65.50048 43.2532)",1995,2016,21,"22",11828
"POINT(-58.93 43.84)",1988,2011,23,"18",15846
"POINT(-48.319336 48.138699)",1984,1995,11,"12",14854
"POINT(-61.164851 45.857738)",1995,1997,2,"3",14073
"POINT(-79.361398 43.62142)",2006,2012,6,"4",13492
"POINT(-74.26141 46.3294)",2011,2013,2,"3",11172
"POINT(-61.56738 44.19795)",1995,2016,21,"22",11959
"POINT(-67 41)",1950,1998,48,"49",13406
"POINT(-61.017433 46.6243)",2008,2010,2,"3",15063
"POINT(-61.56738 44.19795)",1970,1981,11,"12",12464
"POINT(-72.88129 46.69751)",2016,2021,5,"4",16070
"POINT(-74.018383 39.10066)",1982,2015,33,"34",14425
"POINT(-77.72313 43.99472)",2008,2015,7,"2",13835
"POINT(-61.017433 46.6243)",2011,2014,3,"2",15618
"POINT(-57.690888 43.437611)",1983,1993,10,"5",10896
"POINT(-77.229936 44.152886)",1992,2012,20,"21",13476
"POINT(-48.319336 48.138699)",1975,1982,7,"8",14929
"POINT(-65.50048 43.2532)",1982,1994,12,"13",11554
"POINT(-64.554866 46.218937)",2004,2010,6,"7",15321
"POINT(-74.018383 39.10066)",1971,2016,45,"46",14592
"POINT(-74.018383 39.10066)",1967,2005,38,"39",14119
"POINT(-61.56738 44.19795)",1982,1994,12,"13",12571
"POINT(-73.43806 38.53306)",1963,2009,46,"47",14502
"POINT(-79.361398 43.62142)",2006,2012,6,"4",13488
"POINT(-59.348941 46.441917)",1970,1994,24,"18",10806
"POINT(-70.87637 46.85767)",2016,2021,5,"6",16141
"POINT(-77.22225 44.149251)",2001,2015,14,"14",13773
"POINT(-68.615921 41.275324)",1963,2005,42,"43",14399
"POINT(-79.361398 43.62142)",2006,2012,6,"4",13501
"POINT(-66.291594 46.666605)",1970,2014,44,"45",12717
"POINT(-63.2 42)",1973,1986,13,"14",13245
"POINT(-65.3 43)",1970,1997,27,"28",13344
"POINT(-77.72313 43.99472)",2008,2015,7,"2",13772
"POINT(-55.75432 47.86805)",2015,2016,1,"2",11310
"POINT(-78.291582 43.944964)",1974,1985,11,"9",13458
"POINT(-68.615921 41.275324)",1963,2016,53,"54",14764
"POINT(-52.121122 50.695322)",1978,1984,6,"5",10986
"POINT(-61.87121 45.68314)",2011,2014,3,"2",15390
"POINT(-65.50048 43.2532)",1995,2016,21,"22",11354
"POINT(-76.794435 44.062208)",1992,2018,26,"27",13737
"POINT(-63.728047 47.637685)",1970,1994,24,"25",10945
"POINT(-63.06152 46.75491)",1978,2018,40,"41",14551
"POINT(-58.452138 49.69674)",1989,1994,5,"4",10982
"POINT(-63 47)",1978,1990,12,"13",13247
"POINT(-79.361398 43.62142)",2006,2012,6,"4",13473
"POINT(-79.633333 43.683333)",1978,1981,3,"4",10068
"POINT(-77.22225 44.149251)",2001,2015,14,"10",13883
"POINT(-74.018383 39.10066)",1967,2005,38,"39",14394
"POINT(-74.381869 45.160229)",2000,2016,16,"5",13939
"POINT(-65.50048 43.2532)",1970,1981,11,"12",11890
"POINT(-65.50048 43.2532)",1995,2016,21,"22",11515
"POINT(-57.854 44.91813)",1970,2002,32,"33",14131
"POINT(-62.547863 46.172776)",2005,2010,5,"6",15342
"POINT(-77.396957 43.50608)",1978,2018,40,"40",13987
"POINT(-65.50048 43.2532)",1982,1994,12,"13",12528
"POINT(-79.361398 43.62142)",2006,2012,6,"4",13472
"POINT(-49.956886 45.114711)",1970,1994,24,"23",10515
"POINT(-63.446958 46.46855)",2004,2010,6,"7",15054
"POINT(-65.50048 43.2532)",1995,2016,21,"22",11706
"POINT(-61.56738 44.19795)",1970,1981,11,"12",12572
"POINT(-82.448825 48.444828)",2002,2004,2,"3",10108
"POINT(-74.58861 36.44722)",1981,2008,27,"28",14228
"POINT(-51.3 44.3)",1968,1986,18,"19",13172
"POINT(-72.88129 46.69751)",2018,2019,1,"2",16098
"POINT(-63.446958 46.46855)",2004,2010,6,"6",15625
"POINT(-50.457342 50.936521)",1995,2009,14,"15",14838
"POINT(-65.029957 47.777114)",2011,2014,3,"2",15150
"POINT(-74.381869 45.160229)",2006,2018,12,"7",14041
"POINT(-61.56738 44.19795)",1983,1994,11,"12",12085
"POINT(-86 50)",1970,2014,44,"45",12695
"POINT(-56.766309 56.477534)",1978,1991,13,"6",10289
"POINT(-64.873712 47.473463)",2005,2010,5,"5",15626
"POINT(-59 44.1)",1976,1990,14,"15",13279
"POINT(-63.14804 46.23122)",2006,2010,4,"3",15120
"POINT(-65.63232 43.2452)",1970,2007,37,"38",14229
"POINT(-65.50048 43.2532)",1995,2016,21,"22",12221
"POINT(-67 41)",1950,1998,48,"49",13154
"POINT(-60.74811 46.81453)",2006,2014,8,"6",11133
"POINT(-71.71751 46.41901)",2016,2019,3,"4",15972
"POINT(-77.229936 44.152886)",1992,2018,26,"27",13660
"POINT(-65.50048 43.2532)",1995,2016,21,"22",11852
"POINT(-71.71751 46.41901)",2017,2021,4,"3",16019
"POINT(-61.56738 44.19795)",1982,1994,12,"13",12272
"POINT(-77.229936 44.152886)",1992,2018,26,"27",13709
"POINT(-62.623787 44.8325)",1960,2010,50,"51",11265
"POINT(-68.526458 40.575228)",1964,2016,52,"53",14714
"POINT(-64.573724 46.34102)",2008,2009,1,"2",15143
"POINT(-67.86528 44.36722)",1968,1998,30,"26",9944
"POINT(-57.41455 46.93526)",1983,2011,28,"28",14283
"POINT(-65.50048 43.2532)",1995,2016,21,"22",12595
"POINT(-61.56738 44.19795)",1995,2016,21,"22",11667
"POINT(-64.710486 46.475972)",2004,2010,6,"6",15575
"POINT(-65.50048 43.2532)",1985,2016,31,"7",11560
"POINT(-63.06152 46.75491)",1970,2011,41,"42",14307
"POINT(-77.59299 44.01301)",2001,2015,14,"3",13837
"POINT(-77.80861 43.698439)",1997,2012,15,"15",13568
"POINT(-64.11454 46.1827)",2009,2010,1,"2",15340
"POINT(-62.74132 45.67583)",2011,2014,3,"2",15615
"POINT(-74.018383 39.10066)",1968,2011,43,"44",14566
"POINT(-61.56738 44.19795)",1983,1993,10,"6",11595
"POINT(-62.44628 43.89789)",1974,2008,34,"35",14338
"POINT(-74.018383 39.10066)",1968,2011,43,"44",14622
"POINT(-61.181309 42.866877)",1982,1987,5,"5",11121
"POINT(-62.11238 46.383134)",2007,2010,3,"3",15698
"POINT(-65.63232 43.2452)",1980,2008,28,"29",14230
"POINT(-70.87637 46.85767)",2016,2018,2,"3",15938
"POINT(-65.57426 46.98624)",2008,2010,2,"3",15091
"POINT(-61.181309 42.866877)",1983,1990,7,"4",10857
"POINT(-68.615921 41.275324)",1963,2005,42,"43",14347
"POINT(-61.56738 44.19795)",1985,1994,9,"4",12042
"POINT(-74.381869 45.160229)",1984,2008,24,"5",13954
"POINT(-65.50048 43.2532)",1982,1994,12,"12",11500
"POINT(-63 47)",1971,2016,45,"46",10008
"POINT(-62.74132 45.67583)",2011,2014,3,"2",15176
"POINT(-66.11572 44.8247)",1997,2012,15,"16",14437
"POINT(-70.169007 47.453657)",1997,2004,7,"8",15832
"POINT(-68.615921 41.275324)",1963,2016,53,"54",14624
"POINT(-71.093778 40.671798)",1982,2012,30,"31",14351
"POINT(-77.229936 44.152886)",1992,2018,26,"27",13605
"POINT(-63 47)",1971,2016,45,"46",10040
"POINT(-61.56738 44.19795)",1977,1981,4,"2",11864
"POINT(-64.951922 46.75123)",2004,2010,6,"7",15513
"POINT(-76.794435 44.062208)",1992,2018,26,"27",13618
"POINT(-61.56738 44.19795)",1982,1993,11,"12",12160
"POINT(-50 43.083333)",1997,2011,14,"15",13438
"POINT(-56.766309 56.477534)",1978,1991,13,"9",10354
"POINT(-68.615921 41.275324)",1950,2007,57,"58",14543
"POINT(-58.635512 47.364248)",1972,1993,21,"20",10592
"POINT(-61.181309 42.866877)",1970,1994,24,"24",10402
"POINT(-65.50048 43.2532)",1970,1981,11,"12",11708
"POINT(-51 49.15)",1980,1996,16,"17",13178
"POINT(-65.50048 43.2532)",1982,1994,12,"13",11403
"POINT(-61.56738 44.19795)",1982,1994,12,"6",12494
"POINT(-61.56738 44.19795)",1995,2016,21,"22",11400
"POINT(-65.57426 46.98624)",2011,2014,3,"2",15277
"POINT(-65.50048 43.2532)",1982,1994,12,"13",11695
"POINT(-62.11238 46.383134)",2004,2010,6,"7",15232
"POINT(-68.871657 43.27657)",1982,2014,32,"33",14595
"POINT(-65.50048 43.2532)",1995,2016,21,"22",12255
"POINT(-65.50048 43.2532)",1990,1994,4,"2",12219
"POINT(-65.098835 42.729563)",1970,1994,24,"25",10181
"POINT(-63.802767 46.136433)",2005,2007,2,"2",15460
"POINT(-61.56738 44.19795)",1970,1981,11,"12",11992
"POINT(-62.916667 47.416667)",1971,2012,41,"42",15043
"POINT(-73.43806 38.53306)",1963,2009,46,"47",14698
"POINT(-61.56738 44.19795)",1995,2016,21,"15",11846
"POINT(-63.728047 47.637685)",1970,1994,24,"25",10662
"POINT(-82.5 42.166667)",1972,2002,30,"2",10129
"POINT(-65.029957 47.777114)",2004,2009,5,"2",15064
"POINT(-56.766309 56.477534)",1977,1991,14,"5",10467
"POINT(-61.56738 44.19795)",1982,1984,2,"2",12076
"POINT(-53.864595 53.910492)",1973,1989,16,"9",10345
"POINT(-57.690888 43.437611)",1980,1993,13,"8",10999
"POINT(-72.47958 46.88236)",2016,2021,5,"2",15989
"POINT(-65.3 43)",1970,1997,27,"28",13302
"POINT(-63.66575 45.8547)",2011,2014,3,"2",15245
"POINT(-72.88129 46.69751)",2016,2021,5,"6",16018
"POINT(-57.690888 43.437611)",1970,1994,24,"25",10159
"POINT(-58.02978 50.13466)",1973,2003,30,"31",14292
"POINT(-77.229936 44.152886)",1992,2018,26,"27",13769
"POINT(-57.05 51)",1971,1995,24,"25",13295
"POINT(-54 53)",1978,2004,26,"27",11210
"POINT(-77.59299 44.01301)",2001,2015,14,"3",13886
"POINT(-65.50048 43.2532)",1970,1981,11,"12",11326
"POINT(-65.50048 43.2532)",1996,2015,19,"10",11865
"POINT(-68.615921 41.275324)",1950,2016,66,"67",14712
"POINT(-82.517801 41.970728)",2002,2003,1,"2",15034
"POINT(-59 49.25)",1965,2017,52,"53",14752
"POINT(-65.63232 43.2452)",1982,2006,24,"25",14266
"POINT(-58.452138 49.69674)",1972,1994,22,"22",10324
"POINT(-62.74132 45.67583)",2004,2010,6,"7",15640
"POINT(-64.951922 46.75123)",2004,2010,6,"3",15716
"POINT(-53.37158 51.46769)",1979,2011,32,"33",14469
"POINT(-65.50048 43.2532)",1982,1994,12,"13",12120
"POINT(-59 44.1)",1976,1990,14,"15",13384
"POINT(-65.50048 43.2532)",1996,2014,18,"4",12643
"POINT(-63.728047 47.637685)",1974,1993,19,"17",10692
"POINT(-65.50048 43.2532)",1996,2015,19,"10",12399
"POINT(-61.56738 44.19795)",1982,1994,12,"13",12564
"POINT(-86 50)",1970,2014,44,"45",12693
"POINT(-75.363333 35.224444)",1992,1993,1,"2",12652
"POINT(-77.229936 44.152886)",1992,2018,26,"27",13705
"POINT(-77.72313 43.99472)",2008,2015,7,"2",13775
"POINT(-62.067902 49.652037)",1972,1992,20,"11",10492
"POINT(-86 50)",1965,2000,35,"8",9997
"POINT(-56.383301 46.711721)",1984,1993,9,"5",14892
"POINT(-72.88129 46.69751)",2016,2021,5,"6",16009
"POINT(-77.229936 44.152886)",1992,2018,26,"27",13647
"POINT(-70.87637 46.85767)",2019,2021,2,"3",16036
"POINT(-65.090012 44.451082)",1996,1997,1,"2",14054
"POINT(-63.902612 46.237205)",2001,2006,5,"6",10076
"POINT(-77.547686 43.947746)",1992,2012,20,"21",13511
"POINT(-61.455567 46.07815)",2004,2010,6,"7",15693
"POINT(-65.50048 43.2532)",1982,1994,12,"13",12473
"POINT(-64.951922 46.75123)",2004,2010,6,"7",15073
"POINT(-72.88129 46.69751)",2016,2021,5,"6",16063
"POINT(-68.615921 41.275324)",1963,2005,42,"43",14298
"POINT(-60.3 44.1)",1967,1990,23,"24",13312
"POINT(-66.323033 46.650516)",1969,2014,45,"46",11154
"POINT(-68.526458 40.575228)",1982,2016,34,"35",14451
"POINT(-61.181309 42.866877)",1983,1987,4,"4",10421
"POINT(-57.05 51)",1971,1995,24,"25",13148
"POINT(-77.80861 43.698439)",1997,2012,15,"15",13487
"POINT(-65.50048 43.2532)",1970,1978,8,"6",12448
"POINT(-61.56738 44.19795)",1991,1993,2,"3",11620
"POINT(-77.229936 44.152886)",1992,2018,26,"27",13659
"POINT(-65.50048 43.2532)",1982,1993,11,"4",11570
"POINT(-64.573724 46.34102)",2011,2014,3,"2",15258
"POINT(-82.517801 41.970728)",2002,2003,1,"2",15024
"POINT(-76.953595 45.785988)",1999,2000,1,"2",12996
"POINT(-65.50048 43.2532)",1995,2016,21,"22",12198
"POINT(-79.361398 43.62142)",2006,2012,6,"4",13466
"POINT(-55.445135 49.638005)",1988,2009,21,"22",11258
"POINT(-64.126831 46.773778)",2004,2010,6,"7",15590
"POINT(-58.635512 47.364248)",1972,1994,22,"21",10210
"POINT(-52.782383 44.683779)",1970,1994,24,"23",10778
"POINT(-63.902612 46.237205)",2001,2006,5,"6",10077
"POINT(-65.50048 43.2532)",1982,1994,12,"13",11440
"POINT(-71.093778 40.671798)",1967,2005,38,"39",14250
"POINT(-62.547863 46.172776)",2007,2010,3,"4",15538
"POINT(-61.56738 44.19795)",1982,1994,12,"13",12209
"POINT(-57.41455 46.93526)",1983,2011,28,"28",14183
"POINT(-67.5 40.4)",1955,1987,32,"33",13404
"POINT(-86 50)",1970,2014,44,"45",12768
"POINT(-61.56738 44.19795)",1983,1994,11,"12",11551
"POINT(-59.348941 46.441917)",1970,1994,24,"25",10745
"POINT(-65.50048 43.2532)",1995,2016,21,"22",12633
"POINT(-65.57426 46.98624)",2008,2010,2,"3",15487
"POINT(-74.381869 45.160229)",1990,2018,28,"3",13994
"POINT(-65.50048 43.2532)",1982,1994,12,"13",11614
"POINT(-65.50048 43.2532)",1982,1994,12,"13",11974
"POINT(-50 43.083333)",1997,2011,14,"15",13435
"POINT(-74.58861 36.44722)",1985,2014,29,"30",14436
"POINT(-73.107078 52.941847)",1970,2014,44,"45",12705
"POINT(-62.067902 49.652037)",1973,1994,21,"21",10774
"POINT(-77.072526 44.096244)",1992,2018,26,"27",13616
"POINT(-77.229936 44.152886)",1992,2018,26,"27",13598
"POINT(-65.50048 43.2532)",1995,2016,21,"22",11565
"POINT(-63.902612 46.237205)",2001,2006,5,"6",10084
"POINT(-57.854 44.91813)",1970,2002,32,"33",14406
"POINT(-65.62222 47.65259)",2009,2010,1,"2",15604
"POINT(-76.06 44.055)",1976,2015,39,"37",13047
"POINT(-65.098835 42.729563)",1973,1994,21,"19",11083
"POINT(-59.348941 46.441917)",1970,1994,24,"25",10953
"POINT(-65.50048 43.2532)",1996,2012,16,"8",12237
"POINT(-61.56738 44.19795)",1995,2016,21,"22",12122
"POINT(-61.56738 44.19795)",1995,2016,21,"22",12325
"POINT(-57.690888 43.437611)",1982,1990,8,"6",10785
"POINT(-63.394728 46.363106)",2001,2002,1,"2",15853
"POINT(-73.43806 38.53306)",1963,2009,46,"47",14642
"POINT(-86 50)",1970,2014,44,"45",12758
"POINT(-79.361398 43.62142)",2006,2012,6,"4",13580
"POINT(-77.22225 44.149251)",2001,2015,14,"14",13595
"POINT(-70.87637 46.85767)",2016,2021,5,"6",16136
"POINT(-71.71751 46.41901)",2016,2021,5,"5",15966
"POINT(-65.3 43)",1970,1997,27,"28",13407
"POINT(-62.067902 49.652037)",1980,1994,14,"14",10307
"POINT(-65.62222 47.65259)",2009,2010,1,"2",15344
"POINT(-67 41)",1950,1998,48,"49",13238
"POINT(-65.50048 43.2532)",1970,1975,5,"4",12470
"POINT(-57.690888 43.437611)",1982,1987,5,"4",10313
"POINT(-50.3 44.3)",1965,1986,21,"22",13368
"POINT(-57.41455 46.93526)",1983,2011,28,"28",14133
"POINT(-61.56738 44.19795)",1995,2009,14,"7",11611
"POINT(-67.506713 41.1087)",1987,2008,21,"22",11251
"POINT(-61.56738 44.19795)",1970,1981,11,"7",12012
"POINT(-56.383301 46.711721)",1996,2008,12,"5",14963
"POINT(-79.361398 43.62142)",2006,2012,6,"4",13571
"POINT(-84.52551 50.219196)",2016,2017,1,"2",14992
"POINT(-65.50048 43.2532)",1985,2016,31,"7",12361
"POINT(-63.728047 47.637685)",1982,1994,12,"7",10628
"POINT(-59.12841 47.47266)",1974,2010,36,"37",14692
"POINT(-61.56738 44.19795)",1970,1981,11,"12",12315
"POINT(-77.072526 44.096244)",1992,2018,26,"27",14047
"POINT(-65.50048 43.2532)",1982,1994,12,"13",12410
"POINT(-65.57426 46.98624)",2011,2014,3,"2",15300
"POINT(-59.12841 47.47266)",1974,2010,36,"37",14720
"POINT(-59.853639 59.286076)",1978,1991,13,"5",10701
"POINT(-65.50048 43.2532)",1996,2012,16,"8",11436
"POINT(-79.85068 43.28331)",2006,2015,9,"6",13777
"POINT(-52.782383 44.683779)",1970,1994,24,"23",10576
"POINT(-72 54)",1970,2014,44,"45",12824
"POINT(-68.615921 41.275324)",1963,2009,46,"47",14569
"POINT(-65.50048 43.2532)",1982,1994,12,"13",11603
"POINT(-61.56738 44.19795)",1970,1981,11,"12",11677
"POINT(-61.164851 45.857738)",1995,1997,2,"3",14105
"POINT(-57.41455 46.93526)",1983,2011,28,"28",14208
"POINT(-81.87611 45.625)",1950,1983,33,"34",13170
"POINT(-77.547686 43.947746)",1992,2012,20,"21",13565
"POINT(-74.381869 45.160229)",2012,2018,6,"4",14019
"POINT(-63.902612 46.237205)",2001,2006,5,"6",10089
"POINT(-62.650653 47.394909)",1952,2012,60,"60",11303
"POINT(-61.56738 44.19795)",1970,1981,11,"12",11793
"POINT(-52.782383 44.683779)",1973,1993,20,"9",10899
"POINT(-64.951922 46.75123)",2004,2010,6,"7",15135
"POINT(-74.381869 45.160229)",2002,2016,14,"3",13907
"POINT(-63.728047 47.637685)",1984,1988,4,"4",10702
"POINT(-74.381869 45.160229)",1998,2016,18,"5",13993
"POINT(-59.853639 59.286076)",1978,1991,13,"3",10468
"POINT(-72.82857 45.04889)",2016,2021,5,"3",15888
"POINT(-56.383301 46.711721)",1999,2010,11,"10",14865
"POINT(-65.63232 43.2452)",1980,2008,28,"29",14255
"POINT(-62.067902 49.652037)",1983,1994,11,"10",10798
"POINT(-49.956886 45.114711)",1972,1993,21,"13",10272
"POINT(-65.63232 43.2452)",1970,2010,40,"41",14186
"POINT(-77.99944 43.75)",1978,1985,7,"8",13428
"POINT(-66.291594 46.666605)",1970,2014,44,"45",12818
"POINT(-74.381869 45.160229)",1984,2014,30,"6",13980
"POINT(-63.06152 46.75491)",1978,2018,40,"41",14579
"POINT(-48.319336 48.138699)",1996,2010,14,"15",14971
"POINT(-64.126831 46.773778)",2011,2014,3,"2",15295
"POINT(-52.782383 44.683779)",1977,1994,17,"11",10394
"POINT(-63 47)",1971,2016,45,"46",10043
"POINT(-66.486934 47.136578)",2001,2002,1,"2",15859
"POINT(-56.766309 56.477534)",1977,1991,14,"11",10963
"POINT(-62.90725 46.058533)",2011,2014,3,"2",15737
"POINT(-61.56738 44.19795)",1982,1994,12,"13",12434
"POINT(-67 41)",1950,1998,48,"49",13259
"POINT(-65.50048 43.2532)",1970,1981,11,"12",11627
"POINT(-57.41455 46.93526)",1983,2011,28,"28",14408
"POINT(-73.107078 52.941847)",1970,2014,44,"45",12820
"POINT(-61.181309 42.866877)",1971,1993,22,"18",10225
"POINT(-61.56738 44.19795)",1982,1994,12,"13",11884
"POINT(-76.794435 44.062208)",1992,2018,26,"27",13681
"POINT(-65.50048 43.2532)",1996,2016,20,"12",12186
"POINT(-74.381869 45.160229)",2006,2018,12,"7",13999
"POINT(-61.017433 46.6243)",2008,2010,2,"3",15800
"POINT(-72.88129 46.69751)",2016,2021,5,"6",16106
"POINT(-61.181309 42.866877)",1974,1993,19,"11",10689
"POINT(-61.1985 45.9668)",1996,1997,1,"2",14077
"POINT(-61.56738 44.19795)",1970,1981,11,"12",11607
"POINT(-71.71751 46.41901)",2016,2021,5,"6",16121
"POINT(-65.098835 42.729563)",1970,1994,24,"25",10646
"POINT(-59.348941 46.441917)",1970,1993,23,"12",10265
"POINT(-77.72313 43.99472)",2008,2015,7,"2",13877
"POINT(-65.098835 42.729563)",1979,1994,15,"13",10885
"POINT(-63.165833 46.420833)",2011,2014,3,"2",15308
"POINT(-65.50048 43.2532)",1995,2016,21,"22",12495
"POINT(-61.56738 44.19795)",1982,1994,12,"6",12374
"POINT(-71.22259 47.2316)",1984,1994,10,"11",12930
"POINT(-65.8 45)",1979,2001,22,"16",11237
"POINT(-71.093778 40.671798)",1967,2005,38,"39",14350
"POINT(-66.338079 43.726137)",1970,2007,37,"38",11238
"POINT(-73.83333 43)",1983,1992,9,"10",14999
"POINT(-78.56511 67.35631)",2010,2011,1,"2",12991
"POINT(-82.517801 41.970728)",2002,2003,1,"2",15029
"POINT(-77.59299 44.01301)",2001,2015,14,"3",13806
"POINT(-64.34864 48.90011)",1995,2016,21,"2",14831
"POINT(-81.74926 45.1588)",2002,2006,4,"5",13104
"POINT(-70.87637 46.85767)",2016,2021,5,"6",15967
"POINT(-55.39306 45.80582)",1984,1995,11,"12",13081
"POINT(-61.56738 44.19795)",1995,2016,21,"22",12052
"POINT(-64.965766 47.341712)",2004,2010,6,"7",15759
"POINT(-81.74926 45.1588)",2002,2006,4,"5",13106
"POINT(-81.87611 45.625)",1950,1983,33,"34",13296
"POINT(-67 43)",1970,2010,40,"41",14214
"POINT(-68.615921 41.275324)",1950,2016,66,"67",14600
"POINT(-69.555988 48.077602)",1994,1997,3,"4",14817
"POINT(-65.50048 43.2532)",1983,1994,11,"12",12542
"POINT(-61.56738 44.19795)",1982,1994,12,"13",11503
"POINT(-64.554866 46.218937)",2004,2010,6,"7",15077
"POINT(-64.965766 47.341712)",2004,2010,6,"6",15447
"POINT(-61.1985 45.9668)",1996,1997,1,"2",14104
"POINT(-68.3 43.3)",2007,2014,7,"8",14694
"POINT(-52.121122 50.695322)",1971,1991,20,"5",11091
"POINT(-77.396972 43.506083)",1997,2018,21,"9",13946
"POINT(-65.562778 46.995278)",2004,2005,1,"2",15139
"POINT(-74.381869 45.160229)",1990,2018,28,"3",13973
"POINT(-65.63232 43.2452)",1970,2002,32,"33",14410
"POINT(-72.88129 46.69751)",2017,2021,4,"5",16124
"POINT(-52.121122 50.695322)",1970,1994,24,"24",10542
"POINT(-65.50048 43.2532)",1995,2016,21,"22",11335
"POINT(-59 49)",1986,2012,26,"25",11286
"POINT(-61.003018 49.78965)",1990,2010,20,"19",11262
"POINT(-65.098835 42.729563)",1970,1994,24,"25",10186
"POINT(-68.526458 40.575228)",1964,2016,52,"53",14658
"POINT(-65.098835 42.729563)",1970,1994,24,"16",10728
"POINT(-61.56738 44.19795)",1984,1993,9,"4",11879
"POINT(-62.11238 46.383134)",2011,2014,3,"2",15389
"POINT(-68.615921 41.275324)",1963,2005,42,"43",14173
"POINT(-61.56738 44.19795)",1970,1981,11,"12",11395
"POINT(-61.455567 46.07815)",2011,2014,3,"2",15469
"POINT(-64.126831 46.773778)",2005,2010,5,"4",15721
"POINT(-68.615921 41.275324)",1950,2007,57,"58",14711
"POINT(-68.615921 41.275324)",1950,2007,57,"58",14767
"POINT(-61.56738 44.19795)",1995,2010,15,"11",12159
"POINT(-74.018383 39.10066)",1982,2015,33,"34",14705
"POINT(-60.3 44.1)",1967,1990,23,"24",13417
"POINT(-77.072526 44.096244)",1992,2018,26,"27",13671
"POINT(-63 45)",1970,2012,42,"43",12751
"POINT(-86 50)",1970,2014,44,"45",12849
"POINT(-70.87637 46.85767)",2016,2021,5,"6",16117
"POINT(-62.735984 45.290147)",1970,2014,44,"45",12714
"POINT(-61.56738 44.19795)",1970,1981,11,"12",12066
"POINT(-71.71751 46.41901)",2016,2021,5,"5",15936
"POINT(-57.690888 43.437611)",1979,1994,15,"7",10380
"POINT(-64.126831 46.773778)",2011,2014,3,"2",15161
"POINT(-61.181309 42.866877)",1982,1986,4,"3",10499
"POINT(-72.88129 46.69751)",2016,2021,5,"5",16234
"POINT(-61.56738 44.19795)",1970,1981,11,"12",11504
"POINT(-65.57426 46.98624)",2008,2010,2,"3",15531
"POINT(-73.43806 38.53306)",1963,2009,46,"47",14558
"POINT(-62.916667 47.416667)",1971,2012,41,"42",15044
"POINT(-61.56738 44.19795)",1982,1994,12,"13",11463
"POINT(-62.28626 46.36766)",2008,2010,2,"3",15397
"POINT(-66.291594 46.666605)",1970,2014,44,"45",12869
"POINT(-70.87637 46.85767)",2019,2020,1,"2",16223
"POINT(-65.50048 43.2532)",1970,1981,11,"12",12089
"POINT(-77.59299 44.01301)",2001,2015,14,"3",13823
"POINT(-77.547686 43.947746)",1992,2018,26,"27",13633
"POINT(-61.56738 44.19795)",1982,1994,12,"13",12536
"POINT(-78.5 45.58333)",1976,1989,13,"14",10126
"POINT(-65.3 43)",1962,1988,26,"27",13408
"POINT(-77.072526 44.096244)",1992,2018,26,"27",13730
"POINT(-61.56738 44.19795)",1996,2016,20,"11",12220
"POINT(-61.56738 44.19795)",1995,2016,21,"18",12188
"POINT(-61.56738 44.19795)",1995,2016,21,"22",11365
"POINT(-77.229936 44.152886)",1992,2018,26,"27",13665
"POINT(-63.728047 47.637685)",1985,1994,9,"6",10501
"POINT(-61.181309 42.866877)",1970,1994,24,"25",10135
"POINT(-63 45)",1991,2000,9,"6",9999
"POINT(-52.121122 50.695322)",1970,1994,24,"16",10992
"POINT(-77.547686 43.947746)",1992,2012,20,"21",13538
"POINT(-63.14804 46.23122)",2006,2010,4,"3",15530
"POINT(-65.50048 43.2532)",1970,1981,11,"11",12411
"POINT(-74.381869 45.160229)",1988,2014,26,"3",14000
"POINT(-64.657552 47.746584)",2004,2010,6,"7",15398
"POINT(-65.50048 43.2532)",1982,1994,12,"13",11760
"POINT(-64.646046 47.789535)",2004,2007,3,"4",15568
"POINT(-66.05139 45.26667)",1968,1988,20,"21",13427
"POINT(-62.547863 46.172776)",2005,2010,5,"6",15602
"POINT(-72.88129 46.69751)",2016,2018,2,"2",16203
